----------------------------------------------D------------D--------------------------------D---------D-----------------------------------------------
----------------------o-----------------------D------------D--------------------------------D---------D-----------------------------------------------
----------------------------------------------D------------D--------------------------------D---------D-----------------------------------------------
---M---X--gX-g----#---y---#-------------------D------------D--------------------------------D---------D---------------------------------------o--o----
XXXXXXXXXXXXXX-###############----------------D------------D--------------------------------D---------D-----------------------------------------------
XXXXXXXXXXXXXX---------------#----------------D------------D--------------------------------D---------D-----------------------------------------------
-------------X-#---y-----y---#----------------D------------D--------------------------------D---------D----------------D----------------------#-------
-------------X-###############----------------D------------D-----------------------------D--D---------D---------------YD--------------------g##-------
-----------------------------#----------------D------------D-------D------------------------D---------D---------------DD--------------------###-------
---------------#---y-----y---#----------------D------------D--SSS@SSSS---D--------o----D----DDDDDDDDDDD----------------D--------o---------g####-------
-D-D-DD--D-D-DD###############----------------DDDDDDDDDDDDD--------------D--------o------------------------------g-g-g-D--------o---------#####-------
-D-D-D-D-D-D-D-----------------------C-S-S-C-------oo-----------------SSSD--------o------D-------------------DDDDDDDDDDD--------o-------g######-------
-DD--DD--D-D-DD-----------------------------------------------oo-------ooD--------o------D------ooo---oo----D----------D--------o-------#######----F--
-D-D-D-D--D---D----------------------ooo------k--y----y-------oo--g----ooD-D------r------D-------y--Y--y---D-----------D--------o------########----#--
-D-D-D-D--D--DD---------------XXXX--XXXXX-XXXXXXXXXXXXXXXXXXXXXXXXXXXXXXXXXXXX----D----XXXXXXXXXXXXXXXXXXXXXXXXXXXXXXXXXX-------X-----XXXXXXXXXXXXXXXX
------------------------------XXXX--XXXXX-XXXXXXXXXXXXXXXXXXXXXXXXXXXXXXXXXXXX---------XXXXXXXXXXXXXXXXXXXXXXXXXXXXXXXXXX-------X-----XXXXXXXXXXXXXXXX
