----------------------------------------------D------------D------------------------------DD----------------------------------DD----------------------
----------------------------------------------D------------D-------------------------------D----------------------------------DD----------------o-----
--------------------------------------------#-D------------D-------------------------------D-------------------------YYY------DD----------------o-----
--------------------------------------------#-D------------D-------------------------------D-------------------------DDD------DD----------------D-----
----------------------------------------------D------------D-------------------------------D---------------------------D------DD---------------D------
-----------------------------------------#----D------------D-------------------------------D---------------------------D------DD--------------D-------
o----------------------------------------#----D------------D-----------------------------D-D-------------------------D-D------DD----------------------
X----------------------------------------#----D------------D----------------------------YD-D----------D--------------o-D------DD--------DDDD----------
X-------------------------------------------#-D------------D-------D--------------------DD-D-----------------ooo-----o-D------DD----------------D-----
X--------o----------------------------------#-D------------D--SSS@SSSS---D---------------D-DDDDDDDDDDDD---DD-DDDD-DDDDDD-XX---DD----XX-D--------D-----
X--------o----------------------------------#-DDDDDDDDDDDDD--------------D---------g-g-g-D----------D---X----------------XX---DD----XX----------D-----
X--------o---------------------------oo----##------oo-----------------SSSD-----DDDDDDDDDDD-o--------D---X----------------D----------D-----------------
XX--------------D-----*-----D----#---##---###-----------------oo-------ooD----D----------D-*----------o-X----------------D---------*D--------------F--
XX-M-D--gD-gD-g-D-----D-----D-X--#--y--y--###-k--y----y-------oo--g----ooD---D-----------D-D----r-----*-X----------------D*--oooo--D---------------#--
XXXXXXXXXXXXXXXXXXXXXXXXXXXXXXXXXXXXXXXXXXXXXXXXXXXXXXXXXXXXXXXXXXXXXXXXXXXXXXXXXXXXXXXXXXXXXXXXXXXXXXXXX-----------------DDDDDDDDD----XXXXXXXXXXXXXXX
XXXXXXXXXXXXXXXXXXXXXXXXXXXXXXXXXXXXXXXXXXXXXXXXXXXXXXXXXXXXXXXXXXXXXXXXXXXXXXXXXXXXXXXXXXXXXXXXXXXXXXXXX------------------------------XXXXXXXXXXXXXXX
