----------------------------------------------D------------D------------------------------------DD---------D---------D--------------------------------
----------------------------------------------D------------D------------------------------------DD---------D---------D--------------------------------
-----------------------------#----------------D------------D------------------------------------DD---------D---------D--------------------------------
-----------------------------#----------------D------------D------------------------------------DD---------D---------D--------------------------o-----
----------------------------------------------D------------D------------------------------------DD---------D---------D-------------------------o------
--------------------------#-------------------D------------D------------------------------------DD---------D---------D------------------------o-------
--------------------------#-------------------D------------D-----------------------------o------DD---------D---------D------------------------#-------
--------------------------#-------------------D------------D-----------------------------o------DD---------D---------D-----------------------##-------
X------o--o------------------#----------------D------------D-------D---------------------o------DD---------D---------D-----------------------##-------
X------o--o------------------#----------------D------------D--SSS@SSSS---D---------------D-XX---DD----XX---DDDDDDDDDDD--------------------o--##-------
X----------------------------#----------------DDDDDDDDDDDDD--------------D---o-------------XX---DD----XX----------------------------------#--##-------
X------!--!-----------oo----##---------------------oo-----------------SSSD---o----------*--D----------D----------------------------------##--##-------
X-----------------#---##---###-D-----*-----D------------------oo-------ooD---o-------*--D--D---------*D--------ooo---oo--D-----*-----D---##--##----F--
X--M--------g-gX--#--y--y--###-D-----D-----D--k--y----y-------oo--g----ooD------g--g-D--D--D*--oooo--D----------y--Y--y--D-----D-----D-#-##--##----#--
XXXXXXXXXXXXXXXXXXXXXXXXXXXXXXXXXXXXXXXXXXXXXXXXXXXXXXXXXXXXXXXXXXXXXXXXXXXXXXXXXXXXXXXXXX--DDDDDDDDD----XXXXXXXXXXXXXXXXXXXXXXXXXXXXXXX-XX--XXXXXXXXX
XXXXXXXXXXXXXXXXXXXXXXXXXXXXXXXXXXXXXXXXXXXXXXXXXXXXXXXXXXXXXXXXXXXXXXXXXXXXXXXXXXXXXXXXXX---------------XXXXXXXXXXXXXXXXXXXXXXXXXXXXXXX-XX--XXXXXXXXX
