--------------------------------------------------------------------------------------------------------------------------------------------------------------------------------------------------------
--------------------------------------------------------------------------------------------------------------------------------------------------------------------------------------------------------
--------------------------------------------------------------------------------------------------------------------------------------------------------------------------------------------------------
--------------------------------------------------------------------------------------------------------------------------------------------------------------------------------------------------------
--------------------------------------------------------------------------------------------------------------------------------------------------------------------------------------------------------
----S-S-S--------U-----------S-SS-----S---------S----S---S-----------S---------------S---SS--------------U-S---S----US-U-------S--U-------SS-----------------------------U------------------------------
-----------------------C----C----------------------------------C---C-----------------------------------------C------------------------------------------------------------------------------------------
--------------------------------------------------------------------------------------------------------------------------------------------------------------------------------------------------------
--------------------------------------------------------------------------------------------------------------------------------------------------------------------------------------------------------
--------------------------------------------------------------------------------------------------------------------------------------------------------------------------------------------------------
-tt--------tt----C-CS-US----S----C-------#---tt-------#---C----S-ttS----CCC-#------#U-tt------#----SCC-#-C--US--tt--C--CS-S-----C-C-CSS-SS---#----tt---------------------C------------------------------
-tt------tttt-tt-----#---tt---#-----tt---#---tt-------#-#--------tt----#----#--#--##--tt-----##--------#------#-tt---------------------------#----tt----------------------------------------------------
-tt------tttt-tt-----#---tt---#-----tt-tt##tttt#------#-#----tt--tt----#----##-#-###--tt----###tt------#------#-tt-#-------------------------#--#-tt----------------------------------------------------
-tt#g---gtttt-tt-----#---tt#--#gg---tt-tt##tttt#--g---#g#--g#tt--tt----#----##-#####-gttk--####ttg-----#------#-tt-#-------g-ggg-------------##-#-ttg----------#g--------------------------------------F
%||||%-%|||||%||%%%%%|%%%|||%-|||%%%||%|||||||||-%|%%%|||-%||||%%||%%-%|%%%%||-|||||%||||-%|||||||%%%%%|%%%%%%|%||-|%-%%%%%|%|||%%%%%%%%%%%%%||-|%|||%%%%%%%%%%||%%%%%%%%%%%%%%%%%%%%%%%%%%%%%%%%%%%%%%%
||||||-||||||||||||||||||||||-||||||||||||||||||-||||||||-|||||||||||-||||||||-||||||||||-||||||||||||||||||||||||-||-|||||||||||||||||||||||||-||||||||||||||||||||||||||||||||||||||||||||||||||||||||
