--------------------------------------------------------------------------------------------------------------------------------------------------------------------------------------------------------
--------------------------------------------------------------------------------------------------------------------------------------------------------------------------------------------------------
--------------------------------------------------------------------------------------------------------------------------------------------------------------------------------------------------------
--------------------------------------------------------------------------------------------------------------------------------------------------------------------------------------------------------
--------------------------------------------------------------------------------------------------------------------------------------------------------------------------------------------------------
---S-----S-U------------S----S-US----------------------S-------S---S----S--U-S----SU---------S----------S-------SS---U------------SS-------------------------------------------------------------U------
---------------------------------C-------------------------------------------------------------C-------------------------------------C------------------------------------------------------------------
--------------------------------------------------------------------------------------------------------------------------------------------------------------------------------------------------------
--------------------------------------------------------------------------------------------------------------------------------------------------------------------------------------------------------
--------------------------------------------------------------------------------------------------------------------------------------------------------------------------------------------------------
-tt--------Ctt------Ctt-------SC-S--#-#-tt---tt-----------------#U---S-#---C-------C-SS#-CC----S-#tt------tt---S-----C---SUU---C-S--CS-#----------tt---U----------#-----S------------------------C------
-tt---------tt-#-----tt---tt------tt#-#-tt---tt------tt---------#------#-------#-------#---------#tt------tt-tt-------------tt--#------##---tt----tt#---tt--------#-------------------------------------
-tt----tt---tt-##----tt---tt------tt#-#-tt-tttt-tt--#tt---tt#-#-#------#--#---##-------#---#-----#tt-tt---tt-tt---#-----#---tt--#------##tt-tt-tt-tt#---tt--------#-------------------------------------
-ttgg-gtt-g-tt-###g--tt-g-tt----g-tt###-tt-tttt-tt#-#ttg--tt#-#-#---g-g#--#---##----#--#---#-g--##tt-tt---tt-tt---#-#--g#---ttg-#------##tt-tt-ttktt#-g-tt-kg---g-#-####-########################-#####F
%||||-|||-|%||%||||%%||%|%||%-%%|%|||||%||%||||%|||-||||%%|||%|-|%%-|%||%%|%-%||%%-%|%%|%%%|%|%%||||%||%%%||%||%%%|%|%%||%%%|||%|%--%%-||||%||%||||||%|%||-||%%%|%|%||||%||||||||||||||||||||||||%|||||%
|||||-|||-|||||||||||||||||||-|||||||||||||||||||||-|||||||||||-|||-||||||||-|||||-|||||||||||||||||||||||||||||||||||||||||||||||--||-|||||||||||||||||||-|||||||||||||||||||||||||||||||||||||||||||||
