--------------------------------------------------------------------------------------------------------------------------------------------------------------------------------------------------------
--------------------------------------------------------------------------------------------------------------------------------------------------------------------------------------------------------
--------------------------------------------------------------------------------------------------------------------------------------------------------------------------------------------------------
--------------------------------------------------------------------------------------------------------------------------------------------------------------------------------------------------------
--------------------------------------------------------------------------------------------------------------------------------------------------------------------------------------------------------
---------------------S-S---U-------------------SS-SS--SU-S---SS----S-------U---SSU---------------------------------U----------S--------S---S-S--------------------------------------S-------------------
--------------------------C--------------------------------------------C--------------------------------------------------------------C-----------------------------------------------------------------
-------------------------------------------------------------------------------------------------------------------------------------------------------------------------------S------------------------
--------------------------------------------------------------------------------------------------------------------------------------------------------------------------------------------------------
--------------------------------------------------------------------------------------------------------------------------------------------------------------------------------------------------------
#------------#-----------#SC-#--C-Stt--S-C---#S--C-----CC-------tt-----S---C-CS--C-----#-----tt----tt---U-------C-UC--Ctt-U------Ctt#-S----------#----------------------#-S------------------U-UU-------
#--------tt-###-----#----#---#-----tt--------#-------------tt---tt--------------------##-----tt----tt------------------tt--#------tt#-----------##----------------------#-------------------------------
#---tt--#tt#####--#-#----#---#-----tttt------#-------------tt---tt------tt---------tt###tt---tt-tt-tt-tt----#--------#-tt--##--tt-tt#----tt----###--#-------------------#-------------------------------
#g-ktt#-#tt######-#-#gk--#--###g---tttt---gg##----g--------tt--gtt-g----tt--------#tt###tt---tt-tt-tt-tt-kgg#-gk-g---#-ttg-###-tt-tt#--g-tt-gg####gg#gggggg-gg-g-ggggggg#g-ggggggggg-gggggggg-g--ggggggF
||%||||-|||||||||-|-|||%%|%%||||%%%||||%%%||||%--%|-%%%%%%%||%%|||%|-%-%||%%%%%--%||||||||%%%||%||%||%||%||||%||%|%%%|%|||%|||-||%|||%%|%||%|||||||||||||||%||%|%|%|||||||%|||||||||-||||||||%|%%||||||%
|||||||-|||||||||-|-|||||||||||||||||||||||||||--||-||||||||||||||||-|-||||||||--|||||||||||||||||||||||||||||||||||||||||||||-|||||||||||||||||||||||||||||||||||||||||||||||||||||-|||||||||||||||||||
