--------------------------------------------------------------------------------------------------------------------------------------------------------------------------------------------------------
--------------------------------------------------------------------------------------------------------------------------------------------------------------------------------------------------------
--------------------------------------------------------------------------------------------------------------------------------------------------------------------------------------------------------
--------------------------------------------------------------------------------------------------------------------------------------------------------------------------------------------------------
--------------------------------------------------------------------------------------------------------------------------------------------------------------------------------------------------------
S----S----S------U-U------------------U-S---S-----------U--------------S---------S----------------------------------S---S--------S--S-------------------------------SSS-SSSSS-SSS-SSSSSSSSSSSSSSSSSSSSSS
----C----------C--------C------------------------------------C----------C----------------------C---------C--C------------------------------CC--C--------------------------------------------------------
--------------------------------------------------------------------------------------------------------------------------------------------------------------------------------------------------------
--------------------------------------------------------------------------------------------------------------------------------------------------------------------------------------------------------
--------------------------------------------------------------------------------------------------------------------------------------------------------------------------------------------------------
----S-S-#---U#US-C-C#-ttS-------#tt---C---#S---tt#C-----C----S-U----S---S--C------Stt---tt----#S---tt---CS--S----Utt--#---tt----------ttS#-SS--S-----------------tt--------------C----------------------
-#------#----#------#-tt------tt#tt-------#----tt#---------------tt#------#--------tt---tt----#----tt-------------tt--#--#tt#--tt-#---tt-##--#-----------tt------tt-------------------------------------
-#------#----#------#-tt---#tttt#tttt-----#----tt#---------------tt#------#--------tt-tttt---##-tt-tt-tt--tt------tt--#--#tt##-tt-#---tt-##--#--------#tttt----tttt#------------------------------------
-#---g--##---#------#ktt-#-#tttt#tttt---g##-gg-tt#-gg----#g##---#tt#--#g-g#-gg-kk--tt-tttt##-##-tt-tt-tt--tt-g----tt--#--#tt###tt-#g--tt-##--##------k#tttt----tttt#ggg-ggggggggg-gggggg%ggggg%ggggggggF
%|%%%|%%||-%%|%%%%-%||||%|-||||||||||%%%|||%||%|||%||-%%%||||%%%||||%%||%||%||%||-%||%||||||-||%||%||%||%%||%|%-%%||%-|%%||||||||%||-%||%||%%||%%%--%||||||%-%%||||||||%|||||||||%|||||||||||||||||||||%
||||||||||-|||||||-|||||||-||||||||||||||||||||||||||-|||||||||||||||||||||||||||-||||||||||-||||||||||||||||||-|||||-||||||||||||||-|||||||||||||--||||||||-|||||||||||||||||||||||||||||||||||||||||||
