--------------------------------------------------------------------------------------------------------------------------------------------------------------------------------------------------------
--------------------------------------------------------------------------------------------------------------------------------------------------------------------------------------------------------
--------------------------------------------------------------------------------------------------------------------------------------------------------------------------------------------------------
--------------------------------------------------------------------------------------------------------------------------------------------------------------------------------------------------------
--------------------------------------------------------------------------------------------------------------------------------------------------------------------------------------------------------
--S---USS------------S-----S---U--U-U--------------S-----S----------------S----U---SS-S--U-S-S-----------S----------S------------U--------S------S------------------------------------------S------S----
--------------------------------------------------------------C--C-C-C-C---------C-------------------------------------------------------------C--C-----------------------------------------------------
--------------------------------------------------------------------------------------------------------------------------------------------------------------------------------------------------------
--------------------------------------------------------------------------------------------------------------------------------------------------------------------------------------------------------
--------------------------------------------------------------------------------------------------------------------------------------------------------------------------------------------------------
------C--US---tt---tt-----U--CSCSCC-C-Utt-#--C------S-----U---S-USSSSSSStt---S-C-S-------CU---C---tt---tt---SttS-#U--U-#---tt----CU-U--SU---tt-S--S-------------------tt------#-S---U---U---------------
----tt--------tt---tt--tt--------------tt##---#-#----##tt---##----------tt--#-----------#------tt-tt---tt----tt--#-----#-#-tt#-------tt-----tt-------------------#----tt------#-------------------------
----tt--------tt-tttt--tt---#----------tt##---#-##---##tt---##----------tt--#-----------#---#--tt-tt-tttt-#--tt--#-#---#-#-tt#-------tt-----tt-------------------#----tt------#-------------------------
----tt-g------tt-tttt-ktt---#----------tt##---#g###--##tt--k##-g--------ttgg#-------g-g-#--g#g-tt-tt-tttt-#--tt--#-#--g#-##tt#g----#-tt-----tt#-#----------------#--#-tt------#-----------------%------F
%%-%||%|-%%%%%||%||||%|||%%-|%%%%%%%%%%||||-%%|||||-%||||%%|||%|%%%%%%%%|||||%-%%%%-|%|-|%%|||%||%||%||||%|%%||%%|%|%%||-||||||%%%%|%||%%%%%|||%|-%%%-%%-%%-%%--%|--|-||--%---|-%--%%---%---%---|------%
||-|||||-||||||||||||||||||-|||||||||||||||-|||||||-||||||||||||||||||||||||||-||||-|||-||||||||||||||||||||||||||||||||-||||||||||||||||||||||||-|||-||-||-||--||--|-||--|---|-|--||---|---|---|------|
