--------------------------------------------------------------------------------------------------------------------------------------------------------------------------------------------------------
--------------------------------------------------------------------------------------------------------------------------------------------------------------------------------------------------------
--------------------------------------------------------------------------------------------------------------------------------------------------------------------------------------------------------
--------------------------------------------------------------------------------------------------------------------------------------------------------------------------------------------------------
--------------------------------------------------------------------------------------------------------------------------------------------------------------------------------------------------------
---------S--SS-----------------SS--S-------------------------------------SS------S----------S-S-----U-----------------------SS----U-------U------------SS------------SSSSSSSSSS-SSSSSSSSSS-SSSSSSSSSSSSS
C----------------------------------------------------------------------------------------------------------------------C------------------------------------------------------------------C-------------
--------------------------------------------------------------------------------------------------------------------------------------------------------------------------------------------------------
--------------------------------------------------------------------------------------------------------------------------------------------------------------------------------------------------------
--------------------------------------------------------------------------------------------------------------------------------------------------------------------------------------------------------
S-S-tttt---U---------------#-US--------S-CttS---C-tt---U---Ctt---#--#---S--tt---U--tt--U--#--#--ttC-C-C----S-C----U----S--#-------C------CC------#-------Utt-UU--UUUU----------#----------S-------------
----tttt-------------tt---##--------------tt--tt--tt--------tt--##--#------tt------tt-----#--#--tt--------#----tt--------##---------tt---------#-##--tt---tt-------------------#------------------------
-#--tttt-------------tt#-###------------#-tt--tt-#tt--#---#-tt-###--#------tt-tt---tt-----#--#-#tt--------#----tt--tt---###--------#tt--#-----##-###-tt---tt----#--------------#------------------------
-#-#tttt#------------tt#####------kgkgg-#-tt--tt-#tt#-#-#-#-tt####--#-k----tt-tt--kttg---##k-#-#tt-----g--#-g--tt--ttk--###--------#ttg-#----###g####tt---tt---g#----gggg%ggggg#ggggg%gggg-gggggg%gggggF
%|%||||||%%%%%-%-%%%%|||||||-%%%%%|||||%|%||%%||%||||-|%|-|%||||||%%|%|%%--||%||%-||||%%%|||%|%|||%%%%%|%%|%|%-||%%|||-%|||%--%-%-%||||%|%%%%||||||||||%%%||%%%||%%%%|||||||||||||||||||||%||||||||||||%
||||||||||||||-|-|||||||||||-||||||||||||||||||||||||-|||-|||||||||||||||--||||||-||||||||||||||||||||||||||||-|||||||-|||||--|-|-||||||||||||||||||||||||||||||||||||||||||||||||||||||||||||||||||||||
