--------------------------------------------------------------------------------------------------------------------------------------------------------------------------------------------------------
--------------------------------------------------------------------------------------------------------------------------------------------------------------------------------------------------------
--------------------------------------------------------------------------------------------------------------------------------------------------------------------------------------------------------
--------------------------------------------------------------------------------------------------------------------------------------------------------------------------------------------------------
--------------------------------------------------------------------------------------------------------------------------------------------------------------------------------------------------------
-U---SS---------S--------------S---U---------------SSS---S---------S----------------------U---SS--------U--------USS-U----S---UU-S----------S-------------S--SS------SU---------------------------------
--------C------------------C-------------------------------------C------------------C-----------------------------------C-----------------------------------------------C-------------------------------
--------------------------------------------------------------------------------------------------------------------------------------------------------------------------------------------------------
--------------------------------------------------------------------------------------------------------------------------------------------------------------------------------------------------------
--------------------------------------------------------------------------------------------------------------------------------------------------------------------------------------------------------
-C------S---------tt-------S-U----#C-tt----#----Stt---------#-tt#S--------#Ctt--ttCSS-----CC#-----#-CCttC#---#S--C---CttSC---SCC-------------------tt------CS--tt-----C#S-----tt------------------------
--#----#---------#tttt-tt#--#-----#--tt---##-----tt---------#-tt#----#---##-tt--tt----------#-----#---tt-#--##--------tt----------tt-tt------#--#--tt---tt-----tt------#------tt------------------------
--#tt--#----#----#tttt-tt#--#-----#--tt--###-----tt---tt----#-tt#----##-###-tt--tt-------#--#---tt#---tt-#-###-tt-----tt----------tt-tttt----##-#--tt---tt-----tt------#------tt------------------------
g-#ttg-#---g#---g#tttt-tt#--#---g##--tt#-###g-k--tt---ttkg#-#gtt#-g--######-ttgktt---#-#-#--#kg-tt#---tt-#####-tt--g--tt--g-k-----tt-tttt-g-g####g-tt--#tt-----tt------#-kkkkkttkkkkkkkkk%kkkkkkk%kkkkkF
|%||||-|%%%||%%%||||||-|||%%|%--|||%%|||-||||%|-%||--%|||||%|||||%|-%||||||%||||||%%%|%|-|%%|||-|||%%%||%|||||%||%%|%%||%%|%|%%%-%||%||||%|-||||||%||%%|||-%%%%||-%%%%%|%||||||||||||||||||||||||||||||%
||||||-|||||||||||||||-|||||||--||||||||-||||||-|||--||||||||||||||-||||||||||||||||||||-||||||-||||||||||||||||||||||||||||||||-||||||||||-||||||||||||||-||||||-||||||||||||||||||||||||||||||||||||||
