--------------------------------------------------------------------------------------------------------------------------------------------------------------------------------------------------------
--------------------------------------------------------------------------------------------------------------------------------------------------------------------------------------------------------
--------------------------------------------------------------------------------------------------------------------------------------------------------------------------------------------------------
--------------------------------------------------------------------------------------------------------------------------------------------------------------------------------------------------------
--------------------------------------------------------------------------------------------------------------------------------------------------------------------------------------------------------
--S----S---SS----U-----S-U--------U----SS---------------S-----------U-S------S------------S-----------------SS-----------------------U------------------------------------------------------------------
-------------C-----------------------C------------------------------------------------------------------------C-----------------------------------------------------------------------------------------
--------------------------------------------------------------------------------------------------------------------------------------------------------------------------------------------------------
--------------------------------------------------------------------------------------------------------------------------------------------------------------------------------------------------------
--------------------------------------------------------------------------------------------------------------------------------------------------------------------------------------------------------
------#--#S--S---C--tt---C-------#CttSS----tt--C-----------ttS------C---------CSS------------------tt------S--S---Stt-S------#-S---#-C---------------------------#------------------tt------------------
-----##--#--------tttt----tt----##-tt------tt--------------tt------------------------------------tttt---#----------tt----#---#----##---tt------------------------#------------------tt------------------
----###--#------#-tttt--#-tt---###-tt----tttt--------------tt----tt-------tt-----------#-----#---tttt-tt##---------tt#---#---#---###---tt-tt---------------------#------------------tt--tt--------------
-k-####g-#----#-#-tttt-g#-tt--####-tt----ttttg--g-------ggktt-k-gtt--gg---tt-g------##-#g-g#-#---tttt-tt###--------tt#-g-#g--#g-####---tt-ttk-kkkkkk%kkgkkk%kkkkk#kkkkk%kkkkk%kkkk--tt--tt-------------F
%|-|||||%|%%%%|-|%||||%||%||%%||||%||%%%%|||||%%|%%%-%%%|||||%|%|||%%||%%%||%|%%%%%%||-||%||-|%%-||||%|||||%--%%%%%|||%|%||%-||%||||%%%||%|||%||||||||||||||||||||||||||||||||||||%%||%%||%%%%%%%%%%%%%%
||-||||||||||||-||||||||||||||||||||||||||||||||||||-|||||||||||||||||||||||||||||||||-|||||-|||-|||||||||||--||||||||||||||-|||||||||||||||||||||||||||||||||||||||||||||||||||||||||||||||||||||||||||
