--------------------------------------------------------------------------------------------------------------------------------------------------------------------------------------------------------
--------------------------------------------------------------------------------------------------------------------------------------------------------------------------------------------------------
--------------------------------------------------------------------------------------------------------------------------------------------------------------------------------------------------------
--------------------------------------------------------------------------------------------------------------------------------------------------------------------------------------------------------
--------------------------------------------------------------------------------------------------------------------------------------------------------------------------------------------------------
--------SS-SS---S----------------U-------S-SSS-----------S-S--S--S------S-------SSU-SS----------------------S--S----------------------------------------S-------------------------------S---------------
---------------------C---------------------------------C------------------------------------------------------------------------------------------------------------------------------------------------
--------------------------------------------------------------------------------------------------------------------------------------------------------------------------------------------------------
--------------------------------------------------------------------------------------------------------------------------------------------------------------------------------------------------------
--------------------------------------------------------------------------------------------------------------------------------------------------------------------------------------------------------
------CS--S-------C--SC----------C----C---S---tt-U--C--S#------C---tt-tt----------CS--U-Stt-----#U-----tt----tt-----tt-tt----#-CS------------------------------------------------------------S----------
------------------------------tt---tt---------tt--------#---------#tt-tt-#-----#---------tt-----#--#---tt----tt-----tt-tttt--#---------------------#-------------------------------------#--------------
----tt-----------------tt-----tt---tt---------tt--------#-#-------#tt-tt-##--#-#---------tt-tt--#--##--tt-tt-tt---tttt-tttt--#---------------------#-------------------------------------#--------------
----tt-------kkk-#-#g--tt----gtt--gtt--------gtt--kg-g--#-#gg---kg#ttgtt-###-#-#-------g-tt-ttk-#--####tt-tt-tt---ttttktttt--#k---gggggg%gggggg-#gg#gggg-ggggggg#ggggg#gggggg#ggggg#gggg-#ggg-gggggggggF
%%%-||%%--%%%|||-|%||%%||-%%%|||%%|||-%%-%%%%|||%%||%|%%|-|||%-%||||||||%|||-|-|--%%%%%|%||%|||-|%%||||||%||-||%-%|||||||||%%||%%-|||||||||||||%||||||||%|||||||||||||||||||||||||||||||%||||%|||||||||%
|||-||||--||||||-||||||||-|||||||||||-||-||||||||||||||||-||||-|||||||||||||-|-|--|||||||||||||-||||||||||||-|||-||||||||||||||||-||||||||||||||||||||||||||||||||||||||||||||||||||||||||||||||||||||||
