--------------------------------------------------------------------------------------------------------------------------------------------------------------------------------------------------------
--------------------------------------------------------------------------------------------------------------------------------------------------------------------------------------------------------
--------------------------------------------------------------------------------------------------------------------------------------------------------------------------------------------------------
--------------------------------------------------------------------------------------------------------------------------------------------------------------------------------------------------------
--------------------------------------------------------------------------------------------------------------------------------------------------------------------------------------------------------
-S---U------------------------------------S--SS--S----------S---SS------------U-----------S---------U---------------------------S----S---------------------------------------------------------------U--
------C-C-C-C-C-C-C-C-C-C-C-C-C-C-C-C-C-C----------------------------------------------------------------------------------------------------C----------------------------------------------------------
--------------------------------------------------------------------------------------------------------------------------------------------------------------------------------------------------------
--------------------------------------------------------------------------------------------------------------------------------------------------------------------------------------------------------
--------------------------------------------------------------------------------------------------------------------------------------------------------------------------------------------------------
--#--CSSSSSSSSSSSSSSSSSSSSSSSSSSSSSSSSSSSS--S--C--U------------S-----#--------C-tt-------#-------#C-C-C---------U------#S--------------------S-C-------------------------#---------------------------C--
--#----------------------------------------------------#---#--------##-#--------tt------##------##-------tt------------#-------------------------------------------------#------------------------------
--#--------------------------------------------------#-#-#-#-------###-##--tt---tt-#tt-###--tt-###-------tt------------#-------------------------------------------------#------------------------------
#g#-g-------------------------------------------g--#-#-#-#-#gg----####g####ttg-gtt-#tt-###--tt####-----kkttkk----kkkkkk#-kk-kkkkgkkk%-%kkkkkk---kkkkkkk%kkkkkk%kkkkk%kkkk#kkkkk-kk%kkkkkk%kkkkk%kkkkk-kF
|||-|%%%%%%%%%%%%%%%%%%%%%%%%%%%%%%%%%%%%%%%%--%|%%|-|-|%|-|||%%%%||||||||||||%|||-|||-|||%%||||||%%%%%||||||%%%%|||||||%||-|||||||||-|||||||%-%|||||||||||||||||||||||||||||||-|||||||||||||||||||||%|%
|||-|||||||||||||||||||||||||||||||||||||||||--|||||-|-|||-|||||||||||||||||||||||-|||-||||||||||||||||||||||||||||||||||||-|||||||||-||||||||-||||||||||||||||||||||||||||||||-||||||||||||||||||||||||
