--------------------------------------------------------------------------------------------------------------------------------------------------------------------------------------------------------
--------------------------------------------------------------------------------------------------------------------------------------------------------------------------------------------------------
--------------------------------------------------------------------------------------------------------------------------------------------------------------------------------------------------------
--------------------------------------------------------------------------------------------------------------------------------------------------------------------------------------------------------
--------------------------------------------------------------------------------------------------------------------------------------------------------------------------------------------------------
-------SU----------------------S------------U---U-------U------------------------SS--USSS--------------U----SS-----U-------SS-S-----S----S----------------------S---------------------------------------
----------------------------C-------------------------------------------C-----------C-------------------------------------------------------------------------------------------------------------------
--------------------------------------------------------------------------------------------------------------------------------------------------------------------------------------------------------
--------------------------------------------------------------------------------------------------------------------------------------------------------------------------------------------------------
--------------------------------------------------------------------------------------------------------------------------------------------------------------------------------------------------------
--C--C--C--CUS--#---------S-S-------tt--#--SCSC-C-------C-----C------U--S-U---#----USC------##-U-CSS-C-C-U----tt-CSCSC---US------------------S-tt#----U--UCtt-------------------------------------------
----------------#-------------------tt--#--------------#---------#--#--------##-------------##----------------tt------#--------tttt----tt------tt##--------tt---------------tt--------------------------
---tt-----#-----#---tttt-----tt----#tt--#tt--------#-#-#----#---###-#-------###-------------##------------tt--tt------#--------tttt--tttt------tt##----tt--tt-tt------------tt--------------------------
-k-tt-g---#---#-#---ttttg#---ttg---#ttg-#tt------g-#g#-#----#--######----k-####-ggg------#-k##--#-----#-#-ttg-ttk-----#------ggtttt--ttttg#-k-gtt##g-g-tt--tt-tt-gggggggg-ggttggggg#ggggg-ggg#gggggggggF
%|%||%|-%%|%%%|%|%%%||||||%%%|||%%%||||%|||%%%%%%|%|||-|%%%%|%%||||||%%%%|%||||%|||%%%-%%|%|||-%|%%%%%|%|%|||%|||%%%%%|%%%%--||||||%-||||||%|%||||||-|%||%%||%||-||||||||%|||||||||||||||-|||||||||||||%
|||||||-||||||||||||||||||||||||||||||||||||||||||||||-|||||||||||||||||||||||||||||||-|||||||-||||||||||||||||||||||||||||--|||||||-|||||||||||||||-|||||||||||-||||||||||||||||||||||||-||||||||||||||
