--------------------------------------------------------------------------------------------------------------------------------------------------------------------------------------------------------
--------------------------------------------------------------------------------------------------------------------------------------------------------------------------------------------------------
--------------------------------------------------------------------------------------------------------------------------------------------------------------------------------------------------------
--------------------------------------------------------------------------------------------------------------------------------------------------------------------------------------------------------
--------------------------------------------------------------------------------------------------------------------------------------------------------------------------------------------------------
-----------SS---S-S-U-------------S--SS---------------S----SSU-------U-UU--S--S-S--S---------S----------------------------------------------------------------------------------------------------------
---------------C-------------------C--------------------------------------C-----------C--C--------------------------------------------------------------------------------------------------------------
--------------------------------------------------------------------------------------------------------------------------------------------------------------------------------------------------------
--------------------------------------------------------------------------------------------------------------------------------------------------------------------------------------------------------
--------------------------------------------------------------------------------------------------------------------------------------------------------------------------------------------------------
-ttC---#S------S---UC----------tt--SU-----U-#----------Utt---CC------C-CC-S--#------C-S-US-tt---------------------------------------------tt--------------------------#--#S----------------------------C
-tt---##-tt------------#-------tt-----------#----#------tt-----tt------------#-------------tt---------------------------------------------tt--------------------------#--#--------------------------tt--
-tt--###-tt----------#-#-------tt-------tt--#tt#-##--#--tt-----tt------------#-------------tt--tt#----------------------------------------tt--------------------------#--#--------------------------tt--
-tt-####-ttg--g-g-g--#-#-gk----tt-----gktt--#tt#-###-#--tt-----tt--#k-k------#g#g------g---tt--tt#----------------------------------------tt------------g-------------#--#--------------------------tt-F
%||%||||%|||--|%|%|%%|-|%||%%%%||%%%%%||||%%||||-|||-|%%||%%%%%||%%||%|%%%%%%||||%-%%%%|%%%||%%|||%-%%-%%-%%%%-%%-%%%%-%%-%%-%%-%%%-%%-%%%||-%%%%-%%%-%%|%-%%-%%-%%-%%|%%|%%-%%-%%-%%%-%%%-%%%-%%-%%||%%
||||||||||||--||||||||-|||||||||||||||||||||||||-|||-|||||||||||||||||||||||||||||-||||||||||||||||-||-||-||||-||-||||-||-||-||-|||-||-|||||-||||-|||-||||-||-||-||-||||||||-||-||-|||-|||-|||-||-||||||
