--------------------------------------------------------------------------------------------------------------------------------------------------------------------------------------------------------
--------------------------------------------------------------------------------------------------------------------------------------------------------------------------------------------------------
--------------------------------------------------------------------------------------------------------------------------------------------------------------------------------------------------------
--------------------------------------------------------------------------------------------------------------------------------------------------------------------------------------------------------
--------------------------------------------------------------------------------------------------------------------------------------------------------------------------------------------------------
-U-S-----------------------------------------S--U-U---------SS-SS--S-----U---UU----------U---------------U---S--U-S--------------S--------------------------SSS--SSSSSSSSSSSSSSSSSSSSSSSSSSSSSSSSSSSSSSS
-------------------------------------C-----C------------------------------------------------C--------------------------------------C--------------------------------------------------------------------
--------------------------------------------------------------------------------------------------------------------------------------------------------------------------------------------------------
--------------------------------------------------------------------------------------------------------------------------------------------------------------------------------------------------------
--------------------------------------------------------------------------------------------------------------------------------------------------------------------------------------------------------
-C-----S-U----#----#--------------U--S---C-S----CSC#------#------tt--U-CSCSC-CCtt----C#C-C-CS------tt----C------C-----UC------S---#S---------------tt---------------------------------------------------
--#----------###---#--tt------#--------#-----------#-#---##------tt------------tttt---#----------#-tt------------#-#-#---#--------#----------------tt---------------------------------------------------
--#---------#####--#tttt---#--#-tt-----#-----------#-##-###------tt------------tttt---#--------#-##tt-tt---------#-#-#---#-----tt-#-tt--tttttttt-tttt-tttttt---tt---------------------------------------
--#-k-g----#######-#tttt--g#g-#gtt--g--#k---#-k----#g######-----gttg#-------g--tttt-g-#------#-#-##tt-tt--kkg--k-#-#-#--g#ggk--ttg#-tt--tttttttt-tttt-ttttttg-gttggggg%gggggggg%gggggg%ggggg%ggggg%ggggF
%%|%|%|%%%-|||||||%|||||%%|||%||||%%|%%||%%%|-|%%%%||||||||%%-%-|||||%%%%%%%|%%||||%|%|%%%%%%|-|-||||%||%%|||-%|%|-|%|%%|||||%%||||%||%%||||||||-||||%|||||||%|||||||||||||||||||||||||||||||||||||||||%
||||||||||-||||||||||||||||||||||||||||||||||-|||||||||||||||-|-||||||||||||||||||||||||||||||-|-||||||||||||-||||-|||||||||||||||||||||||||||||-|||||||||||||||||||||||||||||||||||||||||||||||||||||||
