--------------------------------------------------------------------------------------------------------------------------------------------------------------------------------------------------------
--------------------------------------------------------------------------------------------------------------------------------------------------------------------------------------------------------
--------------------------------------------------------------------------------------------------------------------------------------------------------------------------------------------------------
--------------------------------------------------------------------------------------------------------------------------------------------------------------------------------------------------------
--------------------------------------------------------------------------------------------------------------------------------------------------------------------------------------------------------
SS-----------S-----S-S--S---S------SS------------S--------S--S-----UU-------------------S----SS------------------------S-US---S----------------U--------------------------------------------------------
--C-----------------------------------------C---------------------C------------------C----C------------------------------------C------------------------------------------------------------------------
--------------------------------------------------------------------------------------------------------------------------------------------------------------------------------------------------------
--------------------------------------------------------------------------------------------------------------------------------------------------------------------------------------------------------
--------------------------------------------------------------------------------------------------------------------------------------------------------------------------------------------------------
--S-C----------tt---#-C------U--tt----ttSS--S------------U--------SCC--------#--#----S---CS#------tt------------tt-------C-U-#-S---------------C-U----C-tt----------------------tt----------------------
---------------tt---#------#----tt----tt---------------#---tt--------------tt#tt##----tt---#-----#tt------tt----tt----#-#----#-----tt-------------------tt--#-------------------tt----------------------
------#--tt----tttt-#----#-#----tt----tt-----tt--------##--tt---##----tt---tt#tt###---tt---#---#-#tt-tt---tt---#tt-tt-#-#----#---#-tt-------------------tt--#-------------------tt-tt------------#------
g--k-g#g-tt----tttt-#g-g-#-#g-#-ttggg-tt---#-tt--g#g-g###-gtt-#-##---gttg-gtt#tt####--tt---##--#-#tt-ttkg-ttg#-#tt-tt-#-#-g-k#g-g#-tt---------g---------tt--#--------------k%kg-tt-tt------------#-----F
|%%|%|||-||%%%%||||-||%|%|-||%|%|||||%||%%%|%||-%|||-||||%|||-|-||%%%||||%||||||||||%%||%%%||%-|-|||%||||%||||%|||%||%|-|%|%|||%||-||-%%-%%%--|%-%%---%-||--|-%-%%%-%--%---||||-||-||-%-----%----|-----%
||||||||-||||||||||-||||||-||||||||||||||||||||-||||-||||||||-|-||||||||||||||||||||||||||||||-|-||||||||||||||||||||||-||||||||||-||-||-|||--||-||---|-||--|-|-|||-|--|---||||-||-||-|-----|----|-----|
