--------------------------------------------------------------------------------------------------------------------------------------------------------------------------------------------------------
--------------------------------------------------------------------------------------------------------------------------------------------------------------------------------------------------------
--------------------------------------------------------------------------------------------------------------------------------------------------------------------------------------------------------
--------------------------------------------------------------------------------------------------------------------------------------------------------------------------------------------------------
--------------------------------------------------------------------------------------------------------------------------------------------------------------------------------------------------------
-------------S------------------------U--U---U---------S-------S------S-U--S-----S-S-SS-SS-----S------------------S----U-S--S-------SS-------S-SSSSSSS-SSSSSSS-SSSS-S-S-SS-SSSSSSSSSSSSSSSSSSSSSSSSSSSSS
--------------------------------------------------------------------------------------------------------------------------------------------------------------------------------------------------------
--------------------------------------------------------------------------------------------------------------------------------------------------------------------------------------------------------
--------------------------------------------------------------------------------------------------------------------------------------------------------------------------------------------------------
--------------------------------------------------------------------------------------------------------------------------------------------------------------------------------------------------------
--------tt------Stt---#--tt-----ttCSS-C-CC---CS-------------------tt-S-SC---U-U---S-S--S------U--Ctt-------S-----#--#--CS-----C----S---tttt-------------------------------------------------------------
#-------tt-------tt--##--tt---#-tt------------------------------tttt------------------------------tt---#----#---##--#tt----------------tttt-------------------------------------------------------------
##-tt---tt-tt----tt-###--tt---#-tt----------#-----------#-------tttt-----tt-----------------------tt-tt##---##-###--#tt---------##-----tttttt-----------------------------------------------------------
###tt-k#tt-ttg---tt####g#tt-kg#-tt----------#---------g-#-----g-ttttk-g--ttg-#-#---g------g-k-----tt-tt###--######--#tt----kg--g##----gttttttggggggggg--gggggg-ggggk-kgkgg-ggggggg-gggggg-gggggg-ggggggF
|||||%||||%|||%%%||||||||||-|||%||%%%%%%%%-%|%%%%-%%%%|-|%-%%%|%|||||%|%%|||%|%|%%%|%%%%--|%|%%%-%||%|||||%%||||||-%|||%%-%||%%|||%%--||||||||||||||||%%||||||%|||||%|||||%|||||||%||||||%||||||%||||||%
|||||||||||||||||||||||||||-||||||||||||||-||||||-|||||-||-|||||||||||||||||||||||||||||--||||||-|||||||||||||||||-||||||-||||||||||--||||||||||||||||||||||||||||||||||||||||||||||||||||||||||||||||||
