--------------------------------------------------------------------------------------------------------------------------------------------------------------------------------------------------------
--------------------------------------------------------------------------------------------------------------------------------------------------------------------------------------------------------
--------------------------------------------------------------------------------------------------------------------------------------------------------------------------------------------------------
--------------------------------------------------------------------------------------------------------------------------------------------------------------------------------------------------------
--------------------------------------------------------------------------------------------------------------------------------------------------------------------------------------------------------
-------------------U-S----SU--------------------------------------------------------------S-------------------------------------------------------------------------------------------------------------
------------------C-------------------------------------------------------------------------------------------C-----------------------------------------------------------------------------------------
--------------------------------------------------------------------------------------------------------------------------------------------------------------------------------------------------------
--------------------------------------------------------------------------------------------------------------------------------------------------------------------------------------------------------
--------------------------------------------------------------------------------------------------------------------------------------------------------------------------------------------------------
#--tttt--Stt------SC---U-S-C--------------#--------------------#US--------------------------------------------SU-------------C-----------------------------------------------------------------------#--
##-tttt---tt-----------------------------##----------------#tt-#-------tt--tt------------------------------------------------------------------------------------------------------------------------#--
##-tttt---tttt--------#-------------tt--###----------------#tt-#---tt--tt--tt------------------------------------------------------------------------------------------------------------------------#--
###ttttg--tttt-g------#-----kg-k-k-gtt-####gk-k-g-g-k-g-g--#tt-#---ttk-tt--tt-g-k-g-k-g-g-gg-k-g--k-g-g-gg-g-g--gg-gg-g-gk-g--kggg-k-g-g-g-g-g-k-g-g-g-g-k-g-g-gggg-g-g-g-g-g-gg-g-g-g-g-gg-gggg-gggg#gF
||||||||%%||||%|-%%%%%|%%%%%||%|%|%|||%||||||%|%|%|%|%|%|%%|||%|%%%|||%||%%||%|%|%|%|%|%|%||%|%|%%|%|%|%||%|%|%%||%||%|%||%|%%||||%|%|%|%|%|%|%|%|%|%|%|%|%|%|%||||%|%|%|%|%|%||%|%|%|%|%||-||||%||||||%
||||||||||||||||-||||||||||||||||||||||||||||||||||||||||||||||||||||||||||||||||||||||||||||||||||||||||||||||||||||||||||||||||||||||||||||||||||||||||||||||||||||||||||||||||||||||||||-||||||||||||
