--------------------------------------------------------------------------------------------------------------------------------------------------------------------------------------------------------
--------------------------------------------------------------------------------------------------------------------------------------------------------------------------------------------------------
--------------------------------------------------------------------------------------------------------------------------------------------------------------------------------------------------------
--------------------------------------------------------------------------------------------------------------------------------------------------------------------------------------------------------
--------------------------------------------------------------------------------------------------------------------------------------------------------------------------------------------------------
---------------------S---S--------------S-U-------------------------------------------------------------SS---S-SSSSS--S--SSS---S-SS-SSSS----S-S--S-SSS-SS-S-SSSSSSS-SSSSSSSSSSS-SSSSSSSSSSSSSSS-SSS-SSSS
---------C-----------------------------------------------------------------------------------------------------------------------------------C----------------------------------------------------------
--------------------------------------------------------------------------------------------------------------------------------------------------------------------------------------------------------
--------------------------------------------------------------------------------------------------------------------------------------------------------------------------------------------------------
--------------------------------------------------------------------------------------------------------------------------------------------------------------------------------------------------------
---------S------------C---------------U---C--------------#-#tt----S--------------C---------------------S----U--------C-------tt--------------S----C---C--C-#-----------------------------------U--------
--------------------------------------------------------##-#tt--------------------------------tt-#----#---tt-----------tt----tt----------------tt----------#--------------------------------------------
----------##-------------------------------------------###-#tt--------------------------------tt-#----#---tt--#--------tt----tt----------------tt----------#--------------------------------------------
k-g-k-g---##g-k-g----g--g-k-k-g-k-k-g--#---k-g-k-g-k-g-###g#tt-g-g-g#k-gk-k-k-g-g-gg-k-k-g----tt##g-k-#---tt-g#ggggg---ttggg-ttgggg#ggggk-k-g-gttg-ggg-gg-g#ggggg-gkggggg--gggg#gggggggg#gggggg-ggg-gggF
|%|%|%|%%%|||%|%|%%%%|%%|%|%|%|%|%|%|%%|%-%|%|%|%|%|%|%|||||||-|%|%|||%||%|%|%|%|%||%|%|%|%%-%|||||%|%|%--||%|||||||-%-|||||%||||||||||||%|%|%||||%|||%||%|||||||%|||||||%-||||||||||||||||||||%|||%|||%
|||||||||||||||||||||||||||||||||||||||||-||||||||||||||||||||-|||||||||||||||||||||||||||||-|||||||||||--||||||||||-|-|||||||||||||||||||||||||||||||||||||||||||||||||||-|||||||||||||||||||||||||||||
