--------------------------------------------------------------------------------------------------------------------------------------------------------------------------------------------------------
--------------------------------------------------------------------------------------------------------------------------------------------------------------------------------------------------------
--------------------------------------------------------------------------------------------------------------------------------------------------------------------------------------------------------
--------------------------------------------------------------------------------------------------------------------------------------------------------------------------------------------------------
--------------------------------------------------------------------------------------------------------------------------------------------------------------------------------------------------------
-------S-S-S-------------------------------------------S--S-S---------U------------------------------------------------------U--------------------------------------------------------S-----------------
-------------------C----------------------------------------------------------------------C-------------------------------------------------------------------------------------------------------------
--------------------------------------------------------------------------------------------------------------------------------------------------------------------------------------------------------
--------------------------------------------------------------------------------------------------------------------------------------------------------------------------------------------------------
--------------------------------------------------------------------------------------------------------------------------------------------------------------------------------------------------------
--------#-U--------SSS------------------#---Ctt---------tt-U----#--C--CCS-----------------S#tt-------------------------------C--S-----------------------------------------------------------------------
--------#-------------------------------#----tt---------tt-----##--------------------------#tt----------------------------------------------------------------------------------------------------------
#-------#-------------------------------#----tt---------tt----###tt-tt---------------------#tt---------------------tttttttttt-tt-tttt-tttttttttttttttttttttttttttttttttttttttttttttttt-tttt-------------
#-k-g-kg#---g-k-g-k----#gk-k-g-k-g--g-g-#gg--tt-g-k-k---tt---####tt-tt---g-k-g-k-k-g-g--k--#ttg-k-g-k-k-k-g-k-g-k--tttttttttt-tt-tttt-ttttttttttttttttttttttttttttttttttttttttttttttttgtttt-ggggg-gggggF
|%|%|%|||%%%|%|%|%|%%%-|||%|%|%|%|%%|%|%|||%%||%|%|%|%%%||-%%||||||%||%%%|%|%|%|%|%|%|%%|%%||||%|%|%|%|%|%|%|%|%|%%||||||||||%||%||||%|||||||||||||||||||||||||||||||||||||||||||||||||||||%|||||%|||||%
||||||||||||||||||||||-|||||||||||||||||||||||||||||||||||-|||||||||||||||||||||||||||||||||||||||||||||||||||||||||||||||||||||||||||||||||||||||||||||||||||||||||||||||||||||||||||||||||||||||||||||
