--------------------------------------------------------------------------------------------------------------------------------------------------------------------------------------------------------
--------------------------------------------------------------------------------------------------------------------------------------------------------------------------------------------------------
--------------------------------------------------------------------------------------------------------------------------------------------------------------------------------------------------------
--------------------------------------------------------------------------------------------------------------------------------------------------------------------------------------------------------
--------------------------------------------------------------------------------------------------------------------------------------------------------------------------------------------------------
--------S---------S---S-------S------SS------------------------------------------SS---SSU-----S-----------------------UU-U-UUU--UUUUU-UUUUSUUU-UUUUUUSUU-UUUUUSUUUU---------------------S--S------------
C-C------C----------------------------------------------------------------------------------------------------------------C-----------------------------------------------------------------------------
--------------------------------------------------------------------------------------------------------------------------------------------------------------------------------------------------------
--------------------------------------------------------------------------------------------------------------------------------------------------------------------------------------------------------
--------------------------------------------------------------------------------------------------------------------------------------------------------------------------------------------------------
SSS------S---#-------U---------C----S-------------------------------------------S---SS--C-----------------------------CC-CSCCC--CCCCC-CCCC-CCC-CCCCCC-CC-CCCCC-CCCC-------------------------------------
----#-------##-#-----------#tt----tt-------------------------------------------------------------------------tttttttt----------------------------------------------------#------------------------------
----##-----###-#---#-----#-#tt----tt-----------------------------------------------------------#-------------tttttttt---------------------------------------------------###-----------------------------
----###g--####-#---#--g#-#-#ttg-gktt---g-k-k-g-k-k-g-g---k-k-g--k-k-k-g-k-g-k-g-----------k-kg-#k-k-g-g-k-g-gtttttttt---------------------g------------------------#################-###-##-###########F
%%%%||||%%||||%|%%%|%%||-|-||||%||||%--|%|%|%|%|%|%|%|%%-|%|%|%%|%|%|%|%|%|%|%|%%%%%%%--%%|%||%||%|%|%|%|%|%|||||||||%%%%%%%%%%-%%%%%%%%%%|%%%-%%%%%%-%%%%%%%%%%%%%|||||||||||||||||%|||-||-|||||||||||%
||||||||||||||||||||||||-|-||||||||||--|||||||||||||||||-|||||||||||||||||||||||||||||--|||||||||||||||||||||||||||||||||||||||-||||||||||||||-||||||-||||||||||||||||||||||||||||||||||-||-||||||||||||
