--------------------------------------------------------------------------------------------------------------------------------------------------------------------------------------------------------
--------------------------------------------------------------------------------------------------------------------------------------------------------------------------------------------------------
--------------------------------------------------------------------------------------------------------------------------------------------------------------------------------------------------------
--------------------------------------------------------------------------------------------------------------------------------------------------------------------------------------------------------
--------------------------------------------------------------------------------------------------------------------------------------------------------------------------------------------------------
--SS--------S------------S--------S---S----------S-------S---S--------------SS----S---------------------------SS---U---------SS---S-------S-------------------------------------------------------------
--------------C-CC--------------------------------------------C----------------------------------------C-------------------C----------C-----------------------------------------------------------------
--------------------------------------------------------------------------------------------------------------------------------------------------------------------------------------------------------
--------------------------------------------------------------------------------------------------------------------------------------------------------------------------------------------------------
--------------------------------------------------------------------------------------------------------------------------------------------------------------------------------------------------------
----tt----C--CSCSS------S------------S-#--ttS-----SttC----#---S#--tt-----S----U------------C-----#----CS--------C--C-------SS--##-----SS-------------------U------------#-------------------------------
tt--tt----------------#------------tt--#tttt-------tt-----#----#--tt------------#---------------##---------------tt------------##-------tt---#---tt-----------------tt--#-------------------------------
tt--tt---#----------#-#------------tt--#tttt-------tt-----#tt--#--tt------------#--tt--#----#--###---------------tt------------##--tt---tt-#-#---tt-----------------tt--#--------tt---------------------
ttg-tt-g-#--g-------#-#g--g-k-g----tt-g#tttt-k-g---tt-k-g-#ttg-#--ttg--k--#-gg--#kgttg-#----#-####k-g---g-g-k-gg-tt-g-k-g------##--tt---ttg#-#---tt-----------------tt--#--------tt--------------------F
|||-||%|%|%-|%%%%%%%|-||%-|%|%|%%%%||%||||||%|%|%%%||%|%|%||||%|-%|||%-|-%|%||%%||||||%|%%%%|%|||||%|%%%|%|%|%||%||%|%|%|%%%%%%||-%||%%%||||-|---||--------%--------||--|--------||------%------%%-----%
|||-|||||||-|||||||||-|||-||||||||||||||||||||||||||||||||||||||-|||||-|-||||||||||||||||||||||||||||||||||||||||||||||||||||||||-||||||||||-|---||--------|--------||--|--------||------|------||-----|
