--------------------------------------------------------------------------------------------------------------------------------------------------------------------------------------------------------
--------------------------------------------------------------------------------------------------------------------------------------------------------------------------------------------------------
--------------------------------------------------------------------------------------------------------------------------------------------------------------------------------------------------------
--------------------------------------------------------------------------------------------------------------------------------------------------------------------------------------------------------
--------------------------------------------------------------------------------------------------------------------------------------------------------------------------------------------------------
---------------------U-S-----------------S-S---------------US--------S-------------------S------------------S----------------------------------------------------------------S--------------------------
------C--C---C----------------------------C---------------------------------------------------------------C---------------------------------------------------------------------------------------------
--------------------------------------------------------------------------------------------------------------------------------------------------------------------------------------------------------
--------------------------------------------------------------------------------------------------------------------------------------------------------------------------------------------------------
--------------------------------------------------------------------------------------------------------------------------------------------------------------------------------------------------------
---U--S--S---Stt---#CC---------S-----Utt--S-CttS-S---------C--------------C#C-U-------#C------#-----------S#--------------------U-----------------C-----tt----------------------------------------------
tt#-----------tt---#------------------tt-----tt-------------------------tt-#-#--------#------##------------#-----------------tt---------tt--------------tt----------------------------------------------
tt#----tt-tt#-tt---#--#---------------tt-----tt--------------#---#--#--#tt-#-#-tt-----#-#---###---------#--#-tt--------------tt---------tt-------#------tt-----tt---------tt----------------------------
tt#-#--tt-tt#-ttk--#--#--g-g-g--k-gk--tt-----tt-g--g-k-g----g#ggg#g-#g-#tt-#-#-ttk-g-##-#-k####--gk-g-g-#--#-tt-g-k-g-g-k-g--tt---ggggggttggggggg#-ggk-gttgggggttgggggggggttggggggggg-gggggggg-ggggggggF
|||%|%%||%|||%|||%%|%%|%%|%|%|%%|%||%%||--%-%||%|%-|%|%|%%%%|||||||%||%|||%|%|%|||%|%||%|-|||||%%||%|%|%|%%|%||%|%|%|%|%|%|%%||%%%||||||||||||||||%|||%||||||||||||||||||||||||||||||%||||||||%||||||||%
||||||||||||||||||||||||||||||||||||||||--|-||||||-||||||||||||||||||||||||||||||||||||||-||||||||||||||||||||||||||||||||||||||||||||||||||||||||||||||||||||||||||||||||||||||||||||||||||||||||||||||
