--------------------------------------------------------------------------------------------------------------------------------------------------------------------------------------------------------
--------------------------------------------------------------------------------------------------------------------------------------------------------------------------------------------------------
--------------------------------------------------------------------------------------------------------------------------------------------------------------------------------------------------------
--------------------------------------------------------------------------------------------------------------------------------------------------------------------------------------------------------
--------------------------------------------------------------------------------------------------------------------------------------------------------------------------------------------------------
------------U-----------------S-----------SS--------S-----------------------------------S-S--------------------------------------------------------S----S-----------------------------------------------
-----------C--C---------------------------------------------------------------CC------------------------------------------------------------------------------------------------------------------------
--------------------------------------------------------------------------------------------------------------------------------------------------------------------------------------------------------
--------------------------------------------------------------------------------------------------------------------------------------------------------------------------------------------------------
--------------------------------------------------------------------------------------------------------------------------------------------------------------------------------------------------------
-----------SC-Stt------------U------------------C----#------US----------------SS------------------------------------------C----------#----------------------#---------------S---------------------------
---------------tt--------------#-#-------------------#---------------------------------------------------------------------#--------##------tt--------------#-tt----------------------------------------
---------------tt--------------#-#-----------tt------#-tt------------------------------------------------------------------#------#-##------tt--#-----------#-tt-----------#----------------------------
-k-g-g-k-g-----ttk-g-g-k-g--k--#g#g-k-g-----gtt-----g##tt-g---gk-g-k--#g-g-k-g--g-k-g-g-gg-k-g-k--k-g------k-g-g----#----g-#------#-##------tt#-#-------%---#-tt-----------#---------------------------F
%|%|%|%|%|%%%%%|||%|%|%|%|%%|%%||||%|%|%%---|||%%-%%|||||%|%%%||%|%|%%||%|%|%|%%|%|%|%|%||-|%|%|%%|%|%%%--%|%|%|%%--|----|%|------|-||-%----|||-|%------|---|-||-----%-----|%--------%%-------%%-------%
|||||||||||||||||||||||||||||||||||||||||---|||||-||||||||||||||||||||||||||||||||||||||||-|||||||||||||--||||||||--|----|||------|-||-|----|||-||------|---|-||-----|-----||--------||-------||-------|
