--------------------------------------------------------------------------------------------------------------------------------------------------------------------------------------------------------
--------------------------------------------------------------------------------------------------------------------------------------------------------------------------------------------------------
--------------------------------------------------------------------------------------------------------------------------------------------------------------------------------------------------------
--------------------------------------------------------------------------------------------------------------------------------------------------------------------------------------------------------
--------------------------------------------------------------------------------------------------------------------------------------------------------------------------------------------------------
-------------------------------------------------------------------------------------------------------------------------------------------------------SSSS--S-USSS--S-S-SSSSSSSS--SSSS-----------------
--------------------------------------------------------------------------------------------------------------------------------------------------------------------------------------------------------
--------------------------------------------------------------------------------------------------------------------------------------------------------------------------------------------------------
--------------------------------------------------------------------------------------------------------------------------------------------------------------------------------------------------------
--------------------------------------------------------------------------------------------------------------------------------------------------------------------------------------------------------
-----------------------------------------------------------------S---------------------------------------------------------------------------------------------C-----------------tt---------------------
------------------------------------------------------------------------------------------------------------------------------------------------------------#--------------------tt---------------------
-------------------------------------------------------------------------------------------------------------------------------------tt--------------------##--------------------tt---------------------
-k-g-k-g-g-k-gk-g-g-k-k-gk-g-k-k-g--g-g-k-g-k-g-k-g-g-g-k--k-k-g--g-k-g-k-k-g-k-g-k-g--k-g-k-g-k-g-g-g-g-g-g-gg-gg-g-gg-g-gg-k-g-g-g-ttg-k-g-g-k-g-g-g-gggg##g--gggg-gkg-ggggg-ggttgggg----------------F
%|%|%|%|%|%|%||%|%|%|%|%||%|%|%|%|%%|%|%|%|%|%|%|%|%|%|%|%%|%|%|%%|%|%|%|%|%|%|%|%|%|%%|%|%|%|%|%|%|%|%|%|%|%||%||%|%||%|%||%|%|%|%|%|||%|%|%|%|%|%|%|%|||||||%%||||%|||%|||||%||||||||%%%%%%%%%%%%%%%%%
||||||||||||||||||||||||||||||||||||||||||||||||||||||||||||||||||||||||||||||||||||||||||||||||||||||||||||||||||||||||||||||||||||||||||||||||||||||||||||||||||||||||||||||||||||||||||||||||||||||||
