--------------------------------------------------------------------------------------------------------------------------------------------------------------------------------------------------------
--------------------------------------------------------------------------------------------------------------------------------------------------------------------------------------------------------
--------------------------------------------------------------------------------------------------------------------------------------------------------------------------------------------------------
--------------------------------------------------------------------------------------------------------------------------------------------------------------------------------------------------------
--------------------------------------------------------------------------------------------------------------------------------------------------------------------------------------------------------
----US-----------S-U--S-SS-----------------------------SS----------------------------SS------------------------S--------S-----------U-----------S----------------S----SS--SSSSSS-SS--SSSS-SSSSS--SSSS--S
--C--------------------------------------------------------------------------------------------------------------------------------------------------C--------------------------------------------------
--------------------------------------------------------------------------------------------------------------------------------------------------------------------------------------------------------
---------------------------------------------------------------------------------------------------------------------------------------------------------------------------------------------S----------
--------------------------------------------------------------------------------------------------------------------------------------------------------------------------------------------------------
--S-C-S-tt---------C-S-S----------------------------ttS-----------------------------S------------------------------SC---------------C----------------S---------------S---S------S--------C--------------
-#------tt------------------------------------------tt--------------------------------------------------------------------------------------------------------------------------------------------------
-#------tt------------------------------------------tt-----------------------------------------------------------------------------------tt---tt--tt----------------------------------------------------
-#---g--ttg-k-g-kg--g-----g-k-g-g-k-g-k-g-k--k-g-k-gtt---k-k-g--g-k--g--g--k-g-g--#----k-g--k-g-k-k-g-k-g----------------g---------------tt---ttggtt---------k----------g-----------g------------------F
%|%%%|%%|||%|%|%||%%|%-%--|%|%|%|%|%|%|%|%|%%|%|%|%|||%%%|%|%|%%|%|%%|%%|%%|%|%|%%|%%--|%|%%|%|%|%|%|%|%|%%%%%%-%%%%%%%%-|%%%%%%%%%%%%%%%||%%%||||||%%%%%%%%%|%%%-%-%%--|%------%--%|----%------%------%
||||||||||||||||||||||-|--|||||||||||||||||||||||||||||||||||||||||||||||||||||||||||--||||||||||||||||||||||||-||||||||-||||||||||||||||||||||||||||||||||||||||-|-||--||------|--||----|------|------|
