--------------------------------------------------------------------------------------------------------------------------------------------------------------------------------------------------------
--------------------------------------------------------------------------------------------------------------------------------------------------------------------------------------------------------
--------------------------------------------------------------------------------------------------------------------------------------------------------------------------------------------------------
--------------------------------------------------------------------------------------------------------------------------------------------------------------------------------------------------------
--------------------------------------------------------------------------------------------------------------------------------------------------------------------------------------------------------
S---------------------------------SS--------------------U---------------------------SU------------------S-----S-----------------------------S----------------S-----------------S------------------------
--------------------------------------------------------------------------------------------------------------------------------------------------------------------------------------------------------
--------------------------------------------------------------------------------------------------------------------------------------------------------------------------------------------------------
--------------------------------------------------------------------------------------------------------------------------------------------------------------------------------------------------------
--------------------------------------------------------------------------------------------------------------------------------------------------------------------------------------------------------
-SS----------------------------------#---U-------------#CC--Ctt-U--------------------C---------------------------------tt--C---------------------tt-----------------------------------------------------
-------------------------------------#tt--------------##-----tt--------------------------------------------#-----------tt-----#------------------tt-----------------------------------------------------
------------------#tt----------------#tt#----------tt###-----tt---------------------------------------#--#-#-----------tt---#-#------------------tt-----------------------------------------------------
---k-g-k-g-k--g-g-#tt-kk-g-g-k-g-gg--#tt#--k-g-g-k-tt###-----tt--g-k--g-k--k-k-g-k-g--k-gk-k-g-g-k-g-k#--#-#--g--------tt---#-#------------------tt---------------------g---%--g-----%------%----g%----F
%%%|%|%|%|%|%%|%|%|||%||%|%|%|%|%||%%||||%%|%|%|%|%|||||%%%%%||%%|%|%%|%|%%|%|%|%|%|%%|%||%|%|%|%|%|%||%%|-|--|------%-||--%|-|---%%--------%----||----------%-----%----|---|--|-----|------|----||----%
||||||||||||||||||||||||||||||||||||||||||||||||||||||||||||||||||||||||||||||||||||||||||||||||||||||||||-|--|------|-||--||-|---||--------|----||----------|-----|----|---|--|-----|------|----||----|
