--------------------------------------------------------------------------------------------------------------------------------------------------------------------------------------------------------
--------------------------------------------------------------------------------------------------------------------------------------------------------------------------------------------------------
--------------------------------------------------------------------------------------------------------------------------------------------------------------------------------------------------------
--------------------------------------------------------------------------------------------------------------------------------------------------------------------------------------------------------
--------------------------------------------------------------------------------------------------------------------------------------------------------------------------------------------------------
------------S----S-------------------------------S---U--------U---S----------------------U-US---S---------------------------SS----------SS-S-SS---------------------------U--------------S--------------
----------------------------------------C-----------------------------------------------------------------------------C-------------------------CC------------------------------------------------------
--------------------------------------------------------------------------------------------------------------------------------------------------------------------------------------------------------
--------------------------------------------------------------------------------------------------------------------------------------------------------------------------------------------------------
--------------------------------------------------------------------------------------------------------------------------------------------------------------------------------------------------------
--C-------S----------------tt-----------S-----tt-----C----CU--Ctt------------------------C#C---U--------U-----#--S----S---C----------Stt--C-----SS---C-----------#--------C-----------------------------
-----------#------#--------tt-------------#tt-tt------------#--tt-----------#----#--------#------tt-----------#-#-----------------#---tt-------------------------#--------------------------------------
tt-#-----#-#------#--------tt-------------#tt-tt---tt-tttt--#--tt-----------#----##--#----#--tt--tt-----------#-#------tt------#tt#---tt----#--------------------#--------------------------------------
tt-#g-k-g#-#-k-g--#-k-k-g-gttg-g-k-k-g----#tt-ttgg#tt-tttt--#--tt-g--k-g-g-g#----###-#k-g-#-gtt--tt-g-g---g-g-###-k-g--tt--g--##tt#-#-tt---g#--g--ggg-gggggg-gggg#gggggggg-gggggg-gggggg--gggggg-ggggggF
||%||%|%||%|-|%|%%|%|%|%|%||||%|%|%|%|%%%%|||%|||||||%||||%%|%%||%|%%|%|%|-||%-%%|||-||%|%|%|||%%||%|%|%%%|%|%|||%|%|%%||-%|%-|||||-|%||--%||%%|%%|||%||||||%|||||||||||||%||||||%||||||%-||||||%||||||%
||||||||||||-|||||||||||||||||||||||||||||||||||||||||||||||||||||||||||||-|||-|||||-||||||||||||||||||||||||||||||||||||-|||-|||||-||||--|||||||||||||||||||||||||||||||||||||||||||||||-||||||||||||||
