--------------------------------------------------------------------------------------------------------------------------------------------------------------------------------------------------------
--------------------------------------------------------------------------------------------------------------------------------------------------------------------------------------------------------
--------------------------------------------------------------------------------------------------------------------------------------------------------------------------------------------------------
--------------------------------------------------------------------------------------------------------------------------------------------------------------------------------------------------------
--------------------------------------------------------------------------------------------------------------------------------------------------------------------------------------------------------
--------------------SSS------------------------U---SS---S----S--------------SSS-S--------------------------------SS-------------------------------------------------------------------------------------
----------------C--------------------------------C-----------------------------C-----C----C--------------C----------------------------------------------------------------------------------------------
--------------------------------------------------------------------------------------------------------------------------------------------------------------------------------------------------------
--------------------------------------------------------------------------------------------------------------------------------------------------------------------------------------------------------
--------------------------------------------------------------------------------------------------------------------------------------------------------------------------------------------------------
------CSS#-----#S-----------------tt-----------CCSS---C----------S-------------S-C#--SS---S--------------SC---------------------#----------------#-------U----------------------------------------------
----#----#--#tt#------------------tt------------------------#---------------------#----------------------------tt-------###----###########-#-##-####-####-#######-########################--------------
--#-#----#--#tt#-----------------#tt-----------------------##--tt-----------------#--------#---------------#---tt-------####--############-#-#######-####-#######-########################--------------
k-#-#----#--#tt#--#-g-g--#k-g-g-k#ttg-k-k-g-k-------------###--tt--g-k--g-g--g--g-#-g------#k-g-k-g-g-k-g--#g#-ttggk-g-k####k#############-#-#######-####-#######k########################-------------F
|%|-|-%%%|%%||||%-|%|-|%%||%|%|%|||||%|%|%|%|%%%%%%%%%%-%%|||-%||%%|%|%%|%|%-|-%|%|%|%%-%%%||%|%|%|%|%|%|%%|||-|||||%|%|||||||||||||||||||%|%|||||||%||||%||||||||||||||||||||||||||||||||------%%-----%
|||-|-|||||||||||-|||-|||||||||||||||||||||||||||||||||-|||||-||||||||||||||-|-||||||||-||||||||||||||||||||||-|||||||||||||||||||||||||||||||||||||||||||||||||||||||||||||||||||||||||||------||-----|
