--------------------------------------------------------------------------------------------------------------------------------------------------------------------------------------------------------
--------------------------------------------------------------------------------------------------------------------------------------------------------------------------------------------------------
--------------------------------------------------------------------------------------------------------------------------------------------------------------------------------------------------------
--------------------------------------------------------------------------------------------------------------------------------------------------------------------------------------------------------
--------------------------------------------------------------------------------------------------------------------------------------------------------------------------------------------------------
--------------------------------S-----------SSS----------S---------S---------------------------S-------------------------SSS-S-SSSSSSUS-------SS-SSSSSSSSSSSSSSSSSSSSSSSSSSSS-SSSSSSSSSSSSSSSSSSSSS-S---
--------------------------------------------------------------------------------------------------------------------------------------------------------------------------------------------------------
--------------------------------------------------------------------------------------------------------------------------------------------------------------------------------------------------------
--------------------------------------------------------------------------------------------------------------------------------------------------------------------------------------------------------
--------------------------------------------------------------------------------------------------------------------------------------------------------------------------------------------------------
-------------ttC-----------------------#tt-S-------------------C-C--tt---------------C---S-#U----#--------SSU---#CttC-------U-S------C---------------------------------------C--------------------------
-------------tt------------------------#tt----------------tttt------tt---------------------#-----#------tt-----##-tt------------------------------------------------------------------------------------
-------------tt------------------------#tt--------------#-tttt#-----tt-#--------------#----#-tt--#------tt----###-tt------------------------------------------------------------------------------------
-g-k-k--k-g--tt-ggk-g-k-g-k-k-g--g-k-gg#ttg---gg-k-g-g-g#-tttt#-#---tt-#k-g--#-gk-g---#-#--#-tt-##k-g-g-tt---####-tt-gk-g--------------gk-g-k----ggg%gg-gg%gggggg%gggggg-gggg-gggggg%ggggggg-gggggg#g##F
%|%|%|%%|%|--||%|||%|%|%|%|%|%|%-|%|%||||||%--||%|%|%|%||-|||||%|%%-||-||%|%%|%||%|%%%|%|%-|%||-|||%|%|%||%%%||||%||%||%|%%%%%%%%%%%%%%||%|%|%%%%||||||-||||||||||||||||%||||%||||||||||||||%||||||||||%
|||||||||||--|||||||||||||||||||-|||||||||||--|||||||||||-|||||||||-||-|||||||||||||||||||-||||-|||||||||||||||||||||||||||||||||||||||||||||||||||||||-||||||||||||||||||||||||||||||||||||||||||||||||
