--------------------------------------------------------------------------------------------------------------------------------------------------------------------------------------------------------
--------------------------------------------------------------------------------------------------------------------------------------------------------------------------------------------------------
--------------------------------------------------------------------------------------------------------------------------------------------------------------------------------------------------------
--------------------------------------------------------------------------------------------------------------------------------------------------------------------------------------------------------
--------------------------------------------------------------------------------------------------------------------------------------------------------------------------------------------------------
-------S----------------SS-U---------------S------------U-------S--------S-UU------S--------------------------------------S-S----S-S----------S-----------S----S---SS--SS-------------------------------
---------------C---------------------------------------------------------------------------------------------------------C------------------------------------------------------------------------------
--------------------------------------------------------------------------------------------------------------------------------------------------------------------------------------------------------
--------------------------------------------------------------------------------------------------------------------------------------------------------------------------------------------------------
--------------------------------------------------------------------------------------------------------------------------------------------------------------------------------------------------------
---SC----------S-----------Ctt--tt--Utt--C#----tt--C--ttC--------tt--------CC---S---------------#---------------Ctt------S---#C#----------------SSSSSSS-SS-SSS--SSS--tt--SSSSSSSSSS-SSSSSSSSSSSSSSSSSSSS
-tt----------tt-------------tt--tt---tt---#-tt-tt-----tt---------tt#--#--------------tt---------#----------#--tt-tt----------#-#-------------------------------------tt---------------------------------
-tt----------tt--------#----tt--tt---tt---#-tt-tt#----tt---------tt#-##----------tt--tt---------#----------#-#tt-tt----------#-#-------------#-----------------------tt---------------------------------
-tt--k-g-g-g-tt---g-##-#----tt--tt---tt---#-tt-tt#g--#tt-k-g-g--gtt####---g--#g--ttg-tt-k-g-g--g#k-g-g-k-g-#k#tt-tt-k-g-g---g#-#-gg-k-k--#k-g#-----------------g---ggttgg------------------------------F
%||%%|%|-|%|%||%%%|%||-|---%||--||%%%||%%%|-||%||||%%|||%|%|%|%%|||||||%%%|%%||%%|||%||%|%|%|%%|||%|%|%|%|%|||||%||%|%|%|%%%||%|%||-|%|%%||%||%%%%%%%%%%%%-%%%%|%%%||||||%%%%%%%%%%%%%%%%%%%%%%%%%%%%%%%
||||||||-|||||||||||||-|---|||--|||||||||||-|||||||||||||||||||||||||||||||||||||||||||||||||||||||||||||||||||||||||||||||||||||||-||||||||||||||||||||||-|||||||||||||||||||||||||||||||||||||||||||||
