--------------------------------------------------------------------------------------------------------------------------------------------------------------------------------------------------------
--------------------------------------------------------------------------------------------------------------------------------------------------------------------------------------------------------
--------------------------------------------------------------------------------------------------------------------------------------------------------------------------------------------------------
--------------------------------------------------------------------------------------------------------------------------------------------------------------------------------------------------------
--------------------------------------------------------------------------------------------------------------------------------------------------------------------------------------------------------
U-----------------S-S--SS----------------------------SS--U-------S----------------------------S----------------S------SS--------------------------------------------------------------------------------
--------C--------------------C-------------------------------------------------------------------C------------------------------------------------------------------------------------------------------
--------------------------------------------------------------------------------------------------------------------------------------------------------------------------------------------------------
--------------------------------------------------------------------------------------------------------------------------------------------------------------------------------------------------------
--------------------------------------------------------------------------------------------------------------------------------------------------------------------------------------------------------
---C-tt#S----------------S-S-S--------------------Ctt----C#---#--------------------#U------C---ttS----U---SSSSS-S--SSS--SSSS-SS-SSS--------SSS-S--SSSSS-SSSSS--SSSttSSS-SSSSSSSSSSSSCSSSSSSSSSSSSSSSSSSS
-tt--tt#---------#------------#--------------------tt-----#tt-#--------tt----------#--------tt-tt-------tt---------------------------------------#----------------tt------------------------------------
-tt--tt#--------##-#----------#--------------------tt--tt-#tt-#--------tt----------#--------tt-tt-------tt--------------------------------------##----------------tt------------------------------------
-tt--tt#-g-k-g-k##-#g-----g-g-#k-k-g-k-g-k-g-k-g-k-ttg-tt-#tt-#g--g-g--ttg-g--k-g--#-k-k-g--tt-tt-k-g--gtt-------g-------------#----k-gk-g------##------------g---tt-----------------------------------F
%||%%|||%|%|%|%|||%||%%%%%|%|%||%|%|%|%|%|%|%|%|%|%|||%||%|||-||-%|%|%%|||%|%%|%|%-|%|%|%|%%||%||%|%|%%|||%%%%%%%|%%%%--%%%%%%%|%%%%|%||%|%%%%%%||%%%%%%%%%%%%|%%%||%%%%%%%%%%%%%%%%%%%%%%%%%%%%%%%%%%%%
|||||||||||||||||||||||||||||||||||||||||||||||||||||||||||||-||-|||||||||||||||||-|||||||||||||||||||||||||||||||||||--||||||||||||||||||||||||||||||||||||||||||||||||||||||||||||||||||||||||||||||||
