--------------------------------------------------------------------------------------------------------------------------------------------------------------------------------------------------------
--------------------------------------------------------------------------------------------------------------------------------------------------------------------------------------------------------
--------------------------------------------------------------------------------------------------------------------------------------------------------------------------------------------------------
--------------------------------------------------------------------------------------------------------------------------------------------------------------------------------------------------------
--------------------------------------------------------------------------------------------------------------------------------------------------------------------------------------------------------
----------------------------SSS----------------------------------SS------------------------------------------------------------------U-------------------------------------------S----S---S-S-----------
-------------------------------------------------------------------------------------------------------------------------------------------------------------------------------------------C------------
--------------------------------------------------------------------------------------------------------------------------------------------------------------------------------------------------------
--------------------------------------------------------------------------------------------------------------------------------------------------------------------------------------------------------
--------------------------------------------------------------------------------------------------------------------------------------------------------------------------------------------------------
---------------------------S---------------------------------------C-----------------------------------------------------------------C----tt----------------------------------S------------S------------
------------------------------------------------------------------------------------------------------------------------------------------tt--------------------------------tt-tt-------tt---tt-tt---tt-
---------------------------------------------------------------------------#--------------------------------------------------------------tt--------------------------------tt-tt-------tt---tt-tt-tttt-
-k-g-k-g-g-k-g--k-g-g---k-k---gg-k-k-g-k-g-g-k-g-k-g--k-g-k-g-----g--k-g-#-#k-g-k-g-k-k-g-k-g-k-g-g-k-k-g--g-g-g-g-k-gg-g-g-g-g-gg-gg-ggggttggg-k-g-gg-gk-g-g-g-g-g--gggg%ggtt-tt-------tt---ttkttkttttF
%|%|%|%|%|%|%|%%|%|%|%%%|%|%%%||%|%|%|%|%|%|%|%|%|%|%%|%|%|%|%%%%-|%%|%|%|-||%|%|%|%|%|%|%|%|%|%|%|%|%|%|%%|%|%|%|%|%||%|%|%|%|%||%||%|||||||||%|%|%||%||%|%|%|%|%|--||||-||||%||-------||-%-||||||||||%
|||||||||||||||||||||||||||||||||||||||||||||||||||||||||||||||||-||||||||-||||||||||||||||||||||||||||||||||||||||||||||||||||||||||||||||||||||||||||||||||||||||--||||||||||||-------||-|-|||||||||||
