--------------------------------------------------------------------------------------------------------------------------------------------------------------------------------------------------------
--------------------------------------------------------------------------------------------------------------------------------------------------------------------------------------------------------
--------------------------------------------------------------------------------------------------------------------------------------------------------------------------------------------------------
--------------------------------------------------------------------------------------------------------------------------------------------------------------------------------------------------------
--------------------------------------------------------------------------------------------------------------------------------------------------------------------------------------------------------
-------------------S------------------------------------US---------SSS------------SS---------S--------------------U---SS-------------------------S---S----------------------SS--S-----------------------
--------------------------------C-----------------------------------------------------------------------------------------------C-----------------------------------------------------------------------
--------------------------------------------------------------------------------------------------------------------------------------------------------------------------------------------------------
--------------------------------------------------------------------------------------------------------------------------------------------------------------------------------------------------------
--------------------------------------------------------------------------------------------------------------------------------------------------------------------------------------------------------
---U-------C#-------US---------CS-SC--ttC--Stt---C---C--C---------S--------------S--------------------------------C--#---#------S-------------------------#---------------------------------------------
------------##---------tt-------------tt-tt-tt--#----------------------------------------------tt-------------------##---#-----------------tt-------------#---------------------------------------------
---------#--##-tttt----tt-----------tttt-tt-tt--#-----tt------#---------------------#-------#--tt------------------###---#---##------------tt-------------#---------------------------------------------
-g--k-k-g#--##gtttt----tt-k-g----g--tttt-tt-tt-g#--#--tt----kg#k-k---gk-g-k-g-k-#---#k-g--#-#-ktt-k-g-k-g-k-g-k-k--###g-k#-gg##g-gggg#gggg-ttgggg-ggg-gggg#gggggg#ggggg#gggg--gg-gg-ggggg#gggggg#ggggggF
-|%%|%|%||-%|||||||-%%%||%|%|%%%%|%%||||%||%||-||%%|%%||%-%%||||%|%%%||%|%|%|%|%|%%%||%|%%|-|%|||%|%|%|%|%|%|%|%|%%||||%||%|||||%|||||||||%||||||%|||%||||||||||||||||||||||%-||%||%|||||||||||||||||||%
-|||||||||-||||||||-||||||||||||||||||||||||||-||||||||||-|||||||||||||||||||||||||||||||||-|||||||||||||||||||||||||||||||||||||||||||||||||||||||||-|||||||||||||||||||||||-||||||||||||||||||||||||||
