--------------------------------------------------------------------------------------------------------------------------------------------------------------------------------------------------------
--------------------------------------------------------------------------------------------------------------------------------------------------------------------------------------------------------
--------------------------------------------------------------------------------------------------------------------------------------------------------------------------------------------------------
--------------------------------------------------------------------------------------------------------------------------------------------------------------------------------------------------------
--------------------------------------------------------------------------------------------------------------------------------------------------------------------------------------------------------
----S--------U------S------U--S--------------------U--S-------S-------------U-------U--SS------S--------SS-------S--------U-----------S--------S-SSSSSS----S-SSSSSSSSSSSSS-SSSSSSSSSSSSSSSSSSSSSSSSSSSSS
-----------------------------------------------C---------------C---------------------------------------------C----------------------------------C-------------------------------------------------------
--------------------------------------------------------------------------------------------------------------------------------------------------------------------------------------------------------
--------------------------------------------------------------------------------------------------------------------------------------------------------------------------------------------------------
--------------------------------------------------------------------------------------------------------------------------------------------------------------------------------------------------------
C----S-------C----tt-Ctt---C-#------tt------C-#Stt-C-C---#--#--S--tt--------C---tt--C------C---------#-S--C--S-CC--#----CSCSC-------tt----------S-----------S-------------U-----------------------------
---------------#--tt--tt-----#------tt--------#-tt--#----##-#-----tt------------tt---#------#---tt--##-------------#----------------tt--------------------#---------------------------------------------
-tt---tt-------#--tt--tt--#--#-tt-#-tt-tt----##-tt--#----##-#-----tt-----tt---#-tt---#---tt-#---tt-###-------------##tt-------------tt------------------#-#---------------------------------------------
-tt---tt-g#---g#--tt--tt#-#-##gttk#-tt-tt#g--##-tt--#----##-#-g-g-ttk-k--ttg-g#-tt-g-#-g-tt-#-ggtt####--------k---g##tt-------gk-g-kttg--------g-ggggggk#-#g-ggggggg-ggggg-gggggg%%%%%gggggggg-ggggggggF
%||-%%||%||%%%||-%||-%|||-|%|||||||%||-||||-%||%||%%|%%%%||%|-|%|%|||%|%%|||%||%||%|%|%|%||%|%||||||||%%%%%%%%|%%%|||||-%%%%%%||%|%||||%%--%%%%|%||||||||-||%|||||||%|||||%|||||||||||||||||||%||||||||%
|||-||||||||||||-|||-||||-||||||||||||-||||-|||||||||||||||||-|||||||||||||||||||||||||||||||||||||||||||||||||||||||||-|||||||||||||||||--||||||||||||||-||||||||||||||||||||||||||||||||||||||||||||||
