--------------------------------------------------------------------------------------------------------------------------------------------------------------------------------------------------------
--------------------------------------------------------------------------------------------------------------------------------------------------------------------------------------------------------
--------------------------------------------------------------------------------------------------------------------------------------------------------------------------------------------------------
--------------------------------------------------------------------------------------------------------------------------------------------------------------------------------------------------------
--------------------------------------------------------------------------------------------------------------------------------------------------------------------------------------------------------
---S-S---------U----------S----S---U------S-----SU------------USS-------S---------------SS-S---S-----------S-----------S----------------S---S-----------------S---------------S-------------------------
----------------------------------------C-----------------C----------------------------C--C-------------C------------------------------------C----C------------------------C----------------------------
--------------------------------------------------------------------------------------------------------------------------------------------------------------------------------------------------------
--------------------------------------------------------------------------------------------------------------------------------------------------------------------------------------------------------
--------------------------------------------------------------------------------------------------------------------------------------------------------------------------------------------------------
----C--S-----C#C--tt---#-C---------C----S--U-----C#-------S---C--S----US--#--------##-#S--S-------------SS----SS-S--U----C--#-#-CC-------S---S----S-C--------#-tt-------C--S-C-S------------------------
-#------------#---tt---#------------#----#--------#--------#tt------------#tt-----###-#-----#tt-------------tt--------------#-#---tt--tt--------tt------tt---#-tt-----#---------------------------------
-#-------tttt-#---tt-tt#---tt---tt--##---#---#tt--#--------#tt-----tt-----#tt-tt-####-#-----#tt-------------tt-------tt-----#-#---tt-#tt---#----tt------tt-tt#-tt---#-#---------------------------------
##---gk--tttt-#--#tt-tt#---ttgg-tt--####-#--k#tt--#gg-g----#tt-gg-ktt---g-#tt-tt#####-#--g--#tt--##g-k-g--ggtt----g--tt---kg###---tt##ttg--#----tt---k-ktt#tt#-ttg-g#-#--#g-#---gggggggg#ggggggg#ggggggF
||%-%||%%||||%|%-|||%|||%%%||||-||%%||||%|%%||||-%|||%|%%%%|||%||%|||%%%|%|||%|||||||%|%%|%-|||%%|||%|%|%%||||%%%%|%%||%%%|||||%%%|||||||%%|-%%%||%%%|%|||||||%|||-||-|-%||%|%%%|||||||||||||||||||||||%
|||-||||||||||||-||||||||||||||-||||||||||||||||-||||||||||||||||||||||||||||||||||||||||||-||||||||||||||||||||||||||||||||||||||||||||||||-|||||||||||||||||||||-||-|-||||||||||||||||||||||||||||||||
