--------------------------------------------------------------------------------------------------------------------------------------------------------------------------------------------------------
--------------------------------------------------------------------------------------------------------------------------------------------------------------------------------------------------------
--------------------------------------------------------------------------------------------------------------------------------------------------------------------------------------------------------
--------------------------------------------------------------------------------------------------------------------------------------------------------------------------------------------------------
--------------------------------------------------------------------------------------------------------------------------------------------------------------------------------------------------------
----S-----------S--------------------S----------S--SU------------S--------S--------U-------S------SS-S--------S-SS-SU-------SS-------S-----S---S-U---------SS-------SSSSSS------------------------------
----------------------------------------------------------------------------------C----C--------------------------------------------------------C-----C-------------------------------------------------
--------------------------------------------------------------------------------------------------------------------------------------------------------------------------------------------------------
--------------------------------------------------------------------------------------------------------------------------------------------------------------------------------------------------------
--------------------------------------------------------------------------------------------------------------------------------------------------------------------------------------------------------
-C----U----------ttC---S-----tt-----#-S----tt--S--S-C--U----------U-UC-#----U-----SC---SS---------------SttU------#-C--tttt--------tt--------tt-SCU-U-S------------S------------------------------U-----
-----------------tt----------tt----##------tt------------------tt------#-#-----#----tt---tt-----------tt-tt-tt----#--tttttt--------tt--------tt----------tt-----------------------------------------tt--
--------tt-------tt---#------tttt-###---tt#tt--------tt--------tt------#-#---tt#----tt---tt----tt-----tt-tt-tt----#--tttttt--------tt-tt--#--tt--------tttt-----------------------------------------tt--
g-g----ktt-k-k-g-tt---#------tttt####--gtt#ttk--gg---tt--------ttg-g--g#k#g--tt#----tt---tt----tt---ggtt-tt-ttg---#g-ttttttk----g-gtt-tt#-#g-tt----#-g-ttttg--g-g-k-------gkkkkkkkk-kkkkkk-kkkkkkk-kttkF
|%|-%%%|||%|%|%|-||%%%|%-%-%%||||||||%%|||||||%%||%%%||%%%%--%%|||%|%%|||||%%|||%%%%||%%%||%%%%||%%%||||%||%|||%-%||%|||||||-%%%|%|||%|||-||%||-%%%|%|%|||||%-|%|%|%%%%%%%|||||||||-||||||%|||||||%||||%
|||-||||||||||||-|||||||-|-||||||||||||||||||||||||||||||||--|||||||||||||||||||||||||||||||||||||||||||||||||||-|||||||||||-||||||||||||-|||||-|||||||||||||-|||||||||||||||||||||-||||||||||||||||||||
