--------------------------------------------------------------------------------------------------------------------------------------------------------------------------------------------------------
--------------------------------------------------------------------------------------------------------------------------------------------------------------------------------------------------------
--------------------------------------------------------------------------------------------------------------------------------------------------------------------------------------------------------
--------------------------------------------------------------------------------------------------------------------------------------------------------------------------------------------------------
--------------------------------------------------------------------------------------------------------------------------------------------------------------------------------------------------------
----------------S-----SS---U-----------U---------------U-----S-----------S--U--S----U-------U----SS-----S--------------------SS------S------------S-----S-----U------------SSSSSSSS-SSSSSSS-SSSSSSSSSSSS
-----------------------------C----------------C------------C-----------------------C----------------------------C---------------C------C---C------------------------------------------------------------
--------------------------------------------------------------------------------------------------------------------------------------------------------------------------------------------------------
--------------------------------------------------------------------------------------------------------------------------------------------------------------------------------------------------------
--------------------------------------------------------------------------------------------------------------------------------------------------------------------------------------------------------
--------------US--------U-#C-S---U----#C-#tt--Stt-----#C---S---ttS---S----C-C-C----SC---CttUC#--S---------S---#SSU--U------CS--UStt-#-CS-U-S----#-----#-----#SC-S------------------U--------------------
-----------#--------#-----#---tt------#--#tt---tt-----#--------tt--------------------tt--tt--#tt----#---------#---#--------------tt-#-----------#-----#----##---------tt-tt-----------------------------
-----------#------#-#----##---tt---tt-#--#tt---tt--tt##---#----tt-------#------------tt--tt--#tt----##---#--tt#---#-----#tt------tt-#-----#-----#---tt#---###------tt-tt#tt-----------------------------
------k-g-g#g-----#-#g-g-##---tt#--tt-#--#ttg--tt--tt##-#-#-kg-tt-----gk#g------g-g--tt#-tt--#tt----###-g#-gtt#---#g-g-k#tt------ttg#-----#----g#-g-tt#kg####------tt-tt#ttgggggggg-ggggggg-ggggg-gggggF
%%--%%|%|%|||%%%%%|-||%|%||%%%|||%%||-|%%||||%%||-%||||%|-|%||%||%%%%%||||%%%%%-|%|%%|||%||%%|||%--%|||%||%||||%%%||%|%||||%%%%%%||||-%%-%|%%%%||%|%|||||||||%%%%%-||%|||||||||||||%|||||||%|||||%|||||%
||--|||||||||||||||-|||||||||||||||||-|||||||||||-|||||||-|||||||||||||||||||||-|||||||||||||||||--||||||||||||||||||||||||||||||||||-||-|||||||||||||||||||||||||-|||||||||||||||||||||||||||||||||||||
