--------------------------------------------------------------------------------------------------------------------------------------------------------------------------------------------------------
--------------------------------------------------------------------------------------------------------------------------------------------------------------------------------------------------------
--------------------------------------------------------------------------------------------------------------------------------------------------------------------------------------------------------
--------------------------------------------------------------------------------------------------------------------------------------------------------------------------------------------------------
--------------------------------------------------------------------------------------------------------------------------------------------------------------------------------------------------------
-U----S-S----S--------U---SS--S---SS--SS-SSU----------------S-----------U--------S-------S-------U--------------U--U------S---------------------------SS------S-------S--------S------------------------
----C-------------C------------------C--C----------C------C-------------------------------------------------C--------------C------C--C--------------------C-------------------------------CCCCCCCCCCCCCC
--------------------------------------------------------------------------------------------------------------------------------------------------------------------------------------------------------
--------------------------------------------------------------------------------------------------------------------------------------------------------------------------------------------------------
--------------------------------------------------------------------------------------------------------------------------------------------------------------------------------------------------------
-C--S-------------Stt-C--------ttS---S--S--C---tt--S------S--#ttttCC----C-#U--S---U-----------CU-C----------S-#-C--C--#----S---#--S--S---#--tt-----C----ttS--------------C---U#--------#--SSSSSSSSSSSSSS
--tt------------#--tt----------tt-----------tt-tt----------#-#tttt----tt-##--------tt--#--#-------------tttt--#-------#--------#--------##--tt-##---tt--tt--------------------#---#----#----------------
--tt-------tt-#-#--tt--tt---tt-tt-----------tt-tt----------#-#tttt----tt-##----tt--tt--#--#-------------tttt--#---#---#--------#---tt--###tttt-##---tt--tt-#-------##-----tt--#--##----#tt--------------
--tt-g-k-g-ttg#-#g-tt#-tt#g-ttgtt---------g-tt-ttk--k-k-g#-#-#tttt--k#tt-##--g-ttg-ttg##gg##g--------g-gtttt-g#k--#---#g----g-k##k-tt--###tttt-##-g-ttg-tt-#----#gg##-gg--tt--#-###g-kg#tt-------------F
%%||%|%|%|%||||%||%|||%||||-|||||%---%-%%-|%||%|||%%|%|%||%|-|||||%%||||%||%%|%|||%||||||||||%%%%%%%%|%|||||%|||%%|%-%||%%%%|%||||%||%-|||||||-||%|%|||-||%|%%--|||||%||%%||%%|-||||%|||||%%%%%%%%%%%%%%
|||||||||||||||||||||||||||-||||||---|-||-||||||||||||||||||-|||||||||||||||||||||||||||||||||||||||||||||||||||||||-|||||||||||||||||-|||||||-||||||||-||||||--|||||||||||||||-||||||||||||||||||||||||
