--------------------------------------------------------------------------------------------------------------------------------------------------------------------------------------------------------
--------------------------------------------------------------------------------------------------------------------------------------------------------------------------------------------------------
--------------------------------------------------------------------------------------------------------------------------------------------------------------------------------------------------------
--------------------------------------------------------------------------------------------------------------------------------------------------------------------------------------------------------
--------------------------------------------------------------------------------------------------------------------------------------------------------------------------------------------------------
-SS----U---------US--------------S-S-----------UU----US-SS---SS-------S------------------U--------U-S--UUS----SS----------------S------------S-SS-U-U----U-SS----S--------------------------------------
---C------------------------------------------------------------C----------------------------------C------------------------------------------------------------------C---------------------------------
--------------------------------------------------------------------------------------------------------------------------------------------------------------------------------------------------------
--------------------------------------------------------------------------------------------------------------------------------------------------------------------------------------------------------
--------------------------------------------------------------------------------------------------------------------------------------------------------------------------------------------------------
---S---C--------#C-U--------tttt----#---#------CC----C-S----U---S---------##----U----tt-#C-U------CS-ttCC-------tttt---------C---CU-----------C---CUC-tt-CS---Stt-----S-U---U---------------------------
#-------tt-#---##-------tt--tttt--#-#---#-----#-----#-----tt--------------##---------tt-#---#-tt-----tt---#tt---tttt------tt--tt----------tt----------tt-------tt---------------------------------------
#-------tt##tt###---tt--tttttttt--#-#tt-#-----#---#-#-----tt--------##----##--------#tt-#---#-tttt---tt---#tt---tttt-----#tt--tt----------tt----------tt#------tt---------------------------------------
#-------tt##tt###---ttg#tttttttt-g#g#tt-#-gg-k#---#-#-----tt------#-##g-g-##---k-##-#tt-#-#-#ktttt---tt---#ttg-gtttt--k-g#ttk-tt---g-g----tt---------#tt#------ttg-k-k-k-kgk-kkkkkkkk#kkkkkkkk%kkkkkkkkF
|%-%--%%|||||||||%%%||||||||||||-||||||-|%||%||%%%|-|%-%--||%-%%%%|-|||-|%||%-%|%||%|||%|%|%||||||%%-||%%%||||%|||||%-|%|||||%||-%%|%|%%%%||%-%%-%%%%||||%%%%%%|||%|%|%|%|||%||||||||||||||||||||||||||%
||-|--||||||||||||||||||||||||||-||||||-|||||||||||-||-|--|||-|||||-|||-|||||-||||||||||||||||||||||-||||||||||||||||-||||||||||-||||||||||||-||-|||||||||||||||||||||||||||||||||||||||||||||||||||||||
