--------------------------------------------------------------------------------------------------------------------------------------------------------------------------------------------------------
--------------------------------------------------------------------------------------------------------------------------------------------------------------------------------------------------------
--------------------------------------------------------------------------------------------------------------------------------------------------------------------------------------------------------
--------------------------------------------------------------------------------------------------------------------------------------------------------------------------------------------------------
--------------------------------------------------------------------------------------------------------------------------------------------------------------------------------------------------------
----S---------------------------------------------------------S---S-S-----S-S----S-US--S-----USU------S-------S--S--S-S-------------S-----------------S-S--------------US-------SSSSSSSSSSSSSSSSSSSSSSSS
----------------------------------C----C-----C-C-------------------------------------------------C------------------------------------------------------------------------------------------------------
--------------------------------------------------------------------------------------------------------------------------------------------------------------------------------------------------------
--------------------------------------------------------------------------------------------------------------------------------------------------------------------------------------------------------
--------------------------------------------------------------------------------------------------------------------------------------------------------------------------------------------------------
tt---ttttC-C-C----ttttU---#-CUtt--S----SU----SSSS-----------S#---------tt----U#tt--C-----U---C-C-S#-CC-------#---------tt-------tt-------------------------tt-------#-CC-C---U#-------------------------
tt---tttt---------tttt---##---tt---------tt------#-----------#---------tt-----#tt---------------#-#----------#---------tt--#----tttt----tt-tt-----#--------tt----tt-#---------#-------------------------
tttt-tttt-------#-tttt--###---tt#--tt----tttt----#-----------#--------#tt-----#tt----#-----#----#-#----tt----#----##---tt--#---#tttt--tttt-tt--tt-#--------tttt--tt-#---------##------------------------
tttt-tttt-#---#-#-tttt-####g--tt#g-tt-g--tttt----#kk-g-g-k-k-#g-----g-#ttk-g--#ttg---#kg#--#----#-#----tt---##-gg-##---tt-g##--#tttt--ttttgttggtt-#-g--g--gtttt#-tt-#---g--k--##gggggg#ggggggg#ggggggggF
||||%||||%|%%%|-|%||||%|||||%%||||%||%|%%||||%%%%|||%|%|%|%|%||%%%%%|-||||%|%%||||%%%||||%%|%%%%|%|%%%%||%%%||%||%||%%%||%|||%%|||||-%|||||||||||-|%|%-|-%||||||%||%|-%%|%%|%%|||||||||||||||||||||||||%
|||||||||||||||-|||||||||||||||||||||||||||||||||||||||||||||||||||||-||||||||||||||||||||||||||||||||||||||||||||||||||||||||||||||-||||||||||||-||||-|-||||||||||||-||||||||||||||||||||||||||||||||||
