--------------------------------------------------------------------------------------------------------------------------------------------------------------------------------------------------------
--------------------------------------------------------------------------------------------------------------------------------------------------------------------------------------------------------
--------------------------------------------------------------------------------------------------------------------------------------------------------------------------------------------------------
--------------------------------------------------------------------------------------------------------------------------------------------------------------------------------------------------------
--------------------------------------------------------------------------------------------------------------------------------------------------------------------------------------------------------
-----------U----S----U------SU--SS--US-------S----S---S---S--------S---S--S-----------S---U-----UU-----------SS----------------------SU--S--S--------------SSSS--SSSSSSS---SSSSSSSSSSSSSSSSSS-S-S-SSSSSS
-----------------C----------------------------------------------------------------------------------------------------------------------C---------------------------------------------------------------
--------------------------------------------------------------------------------------------------------------------------------------------------------------------------------------------------------
--------------------------------------------------------------------------------------------------------------------------------------------------------------------------------------------------------
--------------------------------------------------------------------------------------------------------------------------------------------------------------------------------------------------------
---tt------C-----S--SCSC#----Ctt---UC----U-tt-C-C--tt--Ctt----------tt---S-CCC-#-------S--C-----CC#--------#S---tt--S---------tt------CSS----C#-#-UU-C---------------------------------------#-#-#------
---tt--------tt---tt----#-----tt------#----tt------tt---tt------#---tt---------#-----------tt-----#--------#----tt------------tt--#tt-----tt--#-#-------------------------#------------------#-#-#------
-tttt-------#tt---tt----#tt---tt------#tt--tt--#---tt---tt------##--tt---------#-tt-tt-----tt--#--#--------#----tt---#--------tt#-#tt-----tt--#-#------tt------tt--------##------------------#-#-#------
gttttk-k-k--#ttg--tt----#tt---tt-gg--g#tt-ktt--#---tt---tt-g-g--###-ttk---g----#-tt-tt---#-tt#-#--#-----k-g#---gtt---#g-k---#-tt#-#tt----gttg-#k#---g--tt--ggggttgg-gggg###gggggg#gggg#gggggg#g#g#gggggF
||||||%|%|-%||||-%||%%%%|||%-%||-||%%||||%|||%%|%%%||%-%||-|%|%%|||%|||--%|%%%%|%||-||-%%|%|||-|%%|%%--%|%||%--|||%%%||%|%%%|-|||-|||-%%%||||%|||%%%|%%||%%||||||||-|||||||||||||||||||||||||||||||||||%
||||||||||-|||||-|||||||||||-|||-|||||||||||||||||||||-|||-||||||||||||--||||||||||-||-|||||||-||||||--||||||--||||||||||||||-|||-|||-|||||||||||||||||||||||||||||-||||||||||||||||||||||||||||||||||||
