--------------------------------------------------------------------------------------------------------------------------------------------------------------------------------------------------------
--------------------------------------------------------------------------------------------------------------------------------------------------------------------------------------------------------
--------------------------------------------------------------------------------------------------------------------------------------------------------------------------------------------------------
--------------------------------------------------------------------------------------------------------------------------------------------------------------------------------------------------------
--------------------------------------------------------------------------------------------------------------------------------------------------------------------------------------------------------
-----------------------U--S--SS--------U---------S-----------------------U-------------S--U-----S---------------SU--S---------------------------S------------S------SS---SS-S---------------------------
----------------------------------------C-----------------------C--------------------------C--------------C---C----------C----------C----C--C-----------------------------------------------------------
--------------------------------------------------------------------------------------------------------------------------------------------------------------------------------------------------------
--------------------------------------------------------------------------------------------------------------------------------------------------------------------------------------------------------
--------------------------------------------------------------------------------------------------------------------------------------------------------------------------------------------------------
ttC----#-#S------------Ctt-tt----------CS-----tt----S------U----S----#---C-tt-------------CS---U---U------S---S--C-------S#---U-C-#-S----S--S--------------tt-C#------C---------------------------------
tt-----#-#-#---------tt-tt-tt---------#---#tt-tt--#---------#----tt-##-----tt----#------tt--tt---tt--------------------#--#-tt----##-----------------tt----tt--#-------tt-------------------------------
tt-#---#-#-#-----tt--tt-tt-tt---------#---#tt-tt--#---tttt--#tt#-tt###-----tt----##--#--tt--tt---tt------------#-----#-#--#-tt----##-#-------#---tt--tt#---tt--#--tt---tt-------------------------------
tt-#g-g###-#gk-gkttg-tt-tt-tt--g-k-k--#---#tt-ttgg#---tttt--#tt#-tt###gg---tt----###-#g-tt--ttk--tt--g---#---g-#---g-#-#g-#-tt-g--##-#g------#gg-tt--tt#---tt--##-ttgg-tt------gggg%gggggggk%gggg%gggggF
||%||%||||%|||%|||||-||%||%||%%|%|%|%%|%%%|||%|||||%%%||||-%||||%|||||||%%-||%-%%|||-||%||%%|||%%||%%|%%%|%%%|%|%%%|%|-||%|-||%|%%||%||-%%%%%|||-||%%|||%%%||-%||%||||%||------||||||||||||||||||||||||%
||||||||||||||||||||-|||||||||||||||||||||||||||||||||||||-|||||||||||||||-|||-|||||-|||||||||||||||||||||||||||||||||-||||-|||||||||||-||||||||-||||||||||||-|||||||||||------|||||||||||||||||||||||||
