--------------------------------------------------------------------------------------------------------------------------------------------------------------------------------------------------------
--------------------------------------------------------------------------------------------------------------------------------------------------------------------------------------------------------
--------------------------------------------------------------------------------------------------------------------------------------------------------------------------------------------------------
--------------------------------------------------------------------------------------------------------------------------------------------------------------------------------------------------------
--------------------------------------------------------------------------------------------------------------------------------------------------------------------------------------------------------
S-----------------------S--U-S--------------------------------------SSUS--S--U--U-------U---U-----------S-SS--SS--S--S----S-U--U---U-------------S-S-S--S-S-S----U--U-----------------------------------
-----------------------------------------C----------------------------------------------------C---------------------------------------------------C----C------------------------------------------------
--------------------------------------------------------------------------------------------------------------------------------------------------------------------------------------------------------
--------------------------------------------------------------------------------------------------------------------------------------------------------------------------------------------------------
--------------------------------------------------------------------------------------------------------------------------------------------------------------------------------------------------------
---tt---S---------tt-------CS----------ttS----------#--U-U-S-S--U--S--C------C--Ctt-----C#S-C-S--tt------S------tt-------U--C--C-C-C-C------------S----S-C-U--SCSCSCC-U---------------------------------
---tt-----------#-tt----------#-tt-----tt----------##tt-----------------------tt-tt------#-#----#tt-------------tt--------------#--------------------------------------#-#--------------------------tt--
---tt--#-tt-----#-tt-tt#-tt---#-tt--#tttt---------###tt---#----#-tt--------tt-tt-tt------#-#----#tt-------------tt-tt-----------#-------tt#-#tt------------------------#-#--------------------------tt--
-g-tt--#-ttk-k-g##tt-tt#-tt---#-tt#-#tttt---gk---####tt-#-#-#-k#-tt----gkggtt-tt-tt#--g--#-#-#--#tt-g---g---#-ggtt-ttg--g----k--#------gtt###tt--g---g--g----g---------#k#ggggggg-ggggggg-ggggg-ggggttgF
-|%||-%|%|||%|%|||||%|||-||%%%|%|||-|||||%%-||%--||||||%|%|%|%||%||%%%%||||||%||%|||%%|-%|%|%|%%|||%|%%%|%--|%||||-|||%%|%-%%|%%|%%%%%%||||||||-%|%%%|%%|%-%%|%%%%%%%%%||||||||||%|||||||%|||||%|||||||%
-||||-||||||||||||||||||-||||||||||-|||||||-|||--||||||||||||||||||||||||||||||||||||||-||||||||||||||||||--||||||-|||||||-||||||||||||||||||||-||||||||||-|||||||||||||||||||||||||||||||||||||||||||||
