--------------------------------------------------------------------------------------------------------------------------------------------------------------------------------------------------------
--------------------------------------------------------------------------------------------------------------------------------------------------------------------------------------------------------
--------------------------------------------------------------------------------------------------------------------------------------------------------------------------------------------------------
--------------------------------------------------------------------------------------------------------------------------------------------------------------------------------------------------------
--------------------------------------------------------------------------------------------------------------------------------------------------------------------------------------------------------
U-----------S---S-------------------------------------------S--------S-----------------------SS-SS------------------S----------------------U----S------S-------SS---UUUUUUUUUUUUUUUUUUUUUUUUUUUUUUUUUUUU
-----C-------C---------------C----------------------------C---C--------------------C--------------------------------------------------------------------------------------------------------------------
--------------------------------------------------------------------------------------------------------------------------------------------------------------------------------------------------------
--------------------------------------------------------------------------------------------------------------------------------------------------------------------------------------------------------
--------------------------------------------------------------------------------------------------------------------------------------------------------------------------------------------------------
-----S-------S------U--------S------------ttS---S--------SS#--S-C-U----C--------U-USU-tt-------S--S----------CC--Utt---S-ttUU-S----------C-C-CC-------#-----U-----ttCCCCCCCCCCCCCCCCCCCCCCCCCCCCCCCCCCCC
-tt-#--#----------------------#-----#---#-tt--tt--tt-------#-----#-tt---#----tt-------tt--------------------------tt-----tt-------tt-#---------------##-----------tt------------------------------------
-tt-#--##-----tt--------tt-tt-#-tt--#-#-#-tt--tt--tt-------#-----#-tt---#--#-tt#-#----tttt-----------------#------tt-----tt--#----tt-#--------------###--#--------tt------------------------------------
-ttg#--###--g-tt--g--k-ktt-tt-#-ttgg#-#-#-tt--tt--tt-g-----#-----#-tt---#-g#gtt#-#----ttttgk-g-----kg-k-g#-#----k-tt-g---tt--#-g--tt-#-kg------g--#####-k#gg---gg-tt-----------------------------------F
%||||%%|||%%|%||-%|%%|%|||%||%|%|||||%|-|-||%%||%%||%|%%%%%|%%%%%|%||%%%|%||||||%|%%%-||||||%|-%%%%||%|%||-|-%%%|%||%|-%%||%%|%|%%||%|%||%%%%%%|%%|||||%||||%%%||%||%%%%%%%%%%%%%%%%%%%%%%%%%%%%%%%%%%%%
||||||||||||||||-||||||||||||||||||||||-|-|||||||||||||||||||||||||||||||||||||||||||-||||||||-|||||||||||-|-|||||||||-|||||||||||||||||||||||||||||||||||||||||||||||||||||||||||||||||||||||||||||||||
