--------------------------------------------------------------------------------------------------------------------------------------------------------------------------------------------------------
--------------------------------------------------------------------------------------------------------------------------------------------------------------------------------------------------------
--------------------------------------------------------------------------------------------------------------------------------------------------------------------------------------------------------
--------------------------------------------------------------------------------------------------------------------------------------------------------------------------------------------------------
--------------------------------------------------------------------------------------------------------------------------------------------------------------------------------------------------------
----U--S-------S-------S---S--------------------U---U--------------------S--U-S----SS-----------------S----------S---------------------------SU---S-U-----SS-------------S-SSSSSSSSSSSSSSSSSSSSSSSSSSSSS
----------------C-------------C----------------------------------------------------------------------------------------------C--------------------------------------------------------------------------
--------------------------------------------------------------------------------------------------------------------------------------------------------------------------------------------------------
--------------------------------------------------------------------------------------------------------------------------------------------------------------------------------------------------------
--------------------------------------------------------------------------------------------------------------------------------------------------------------------------------------------------------
----CC------S---SU------------S--C-------#------C---C---U#--ttS--------U--C-C--SC#S--------tt------------tt----tt-------tt--SS---#----CStt----CU----C-tt-----U------------C-----------------------------
--#-----#---------tt#---#tt-------------##-----------tt#-#--tt-tt---#--------#---#---------tttt---#tt--tttt##--tt-------tt#----tt#--#---tt------------tt------------##----------------------------------
-##-----#---------tt#tt-#tt-----#------###tt-#---#---tt#-#--tt-tt-tt###------#---#---------tttt---#tt--tttt###-tt-------tt#----tt#--#---tt-------#----tt--------tt#-##----------------------------------
####----#g-k-g-g--tt#ttg#ttg-g-##-k-k--###tt-#---#g--tt#-#--tt-tt-tt###-#----#---#---kg--g-tttt--g#ttg-tttt####ttg-k-g--tt#g--#tt#g-##--tt---g---#---gttk-g-g-g-tt#-##g-gg-gggggggg-gggggg-gggggg-gggggF
||||%%%-||%|%|%|%%||||||||||%|%||%|%|%%|||||-|%-%||%%|||%|%%||%||%|||||%|%%%%|-%%|%--||%%|%||||%%|||||-|||||||||||-|%|%%||||%%|||||%||%%||%%%|%%%|%%%||||%|-|%|%|||-|||%||%||||||||%||||||%||||||%|||||%
|||||||-||||||||||||||||||||||||||||||||||||-||-||||||||||||||||||||||||||||||-||||--|||||||||||||||||-|||||||||||-||||||||||||||||||||||||||||||||||||||||-|||||||-||||||||||||||||||||||||||||||||||||
