--------------------------------------------------------------------------------------------------------------------------------------------------------------------------------------------------------
--------------------------------------------------------------------------------------------------------------------------------------------------------------------------------------------------------
--------------------------------------------------------------------------------------------------------------------------------------------------------------------------------------------------------
--------------------------------------------------------------------------------------------------------------------------------------------------------------------------------------------------------
--------------------------------------------------------------------------------------------------------------------------------------------------------------------------------------------------------
S-----------------U---S---S-----------USS------SS-SS--------------U--S---------------S-----------UU---------U--S-S---S-SS-------S-----------U-----------------------------------------------------------
------------------------------------------C--------------------------------------------------C---------------------------------------------C------------------------------------------------------------
--------------------------------------------------------------------------------------------------------------------------------------------------------------------------------------------------------
--------------------------------------------------------------------------------------------------------------------------------------------------------------------------------------------------------
--------------------------------------------------------------------------------------------------------------------------------------------------------------------------------------------------------
-#--#------#------C--C-----S---tt-----C---SCU-S--S---C-------SU--CCC------tt------#-#--------S---CC------S--C-#-------S------------S---CU-SSC----tt--#-CCSS------C-U-------------------------------S----
-#tt#-----##----#--------#-----tt------------------------------#------tt##tt------#-#---------------------tt-##---------------------#---------tt-tt--#--------------------------------------------------
-#tt#----###---##------#-#-----tt---------------------tt-------#----#-tt##tt-#--tt#-#-------#-------------tt-##-#---#-----#tt-------#--------#tt-tt--#----------#-#-------------------------------------
-#tt#--g-###k-###--gg-g#-#--g--tt-k-k#--g------gg-----tt---k---#----#-tt##ttg#g-tt###-k-g--k#------g-k----tt-##-#g-##----g#tt---g-g-#-k------#ttgtt-g#------g-#-#-#-ggggg-gggg-ggggg-ggggg-gggggggg-gggF
-||||%%|%||||%|||%%||%||-|%%|%%||%|%||%%|%%%%%%||%%%%%||%%%|%%%|%%%%|%|||||||||%|||||-|%|%%||%%%%%%|%|%%%%||%||%||%||-%--||||%%%|%|%|%|%%%%%%||||||%||%%%%%%|%|-|%|%|||||%||||%|||||%|||||%||||||||%|||%
-|||||||||||||||||||||||-||||||||||||||||||||||||||||||||||||||||||||||||||||||||||||-|||||||||||||||||||||||||||||||-|--||||||||||||||||||||||||||||||||||||||-||||||||||||||||||||||||||||||||||||||||
