--------------------------------------------------------------------------------------------------------------------------------------------------------------------------------------------------------
--------------------------------------------------------------------------------------------------------------------------------------------------------------------------------------------------------
--------------------------------------------------------------------------------------------------------------------------------------------------------------------------------------------------------
--------------------------------------------------------------------------------------------------------------------------------------------------------------------------------------------------------
--------------------------------------------------------------------------------------------------------------------------------------------------------------------------------------------------------
U----S--U-S-S------U-U-S-S-------S----U-----S-----S------S-S--S-SU----------------------------------U------------------------U-S-S-U--S-------------------------------U-----------U---------U-UUUUUUUUUU
-----------------------------------------------------------------------------------------C------------C------------C-------CC--------------------C---C----C---------------------------------------------
--------------------------------------------------------------------------------------------------------------------------------------------------------------------------------------------------------
--------------------------------------------------------------------------------------------------------------------------------------------------------------------------------------------------------
--------------------------------------------------------------------------------------------------------------------------------------------------------------------------------------------------------
--------C------#---C-C--------#-C-ttttC----C-----#-U-U---------U-C---ttSU-----S-------UU-S---##tt-C-C-Stt#---------S---#---SSC--#-SC---ttC-C----SS---S----SC---#C-----C---tt---S--C-S-S-SSS-CSCCCCCCCCCC
-tt----#------##--#-------tt--#---tttt--#--------#-----tt---#--------tt--------------------tt##tt------tt#-------tt-tt-#--#-----#---tt-tt----tt-----#----------#----------tt----------------------------
-tt----#-----###-##-------tt--#---tttt--#tt--#-###--#--tt---#-------#tt--------tt#---------tt##tt------tt#--#----tt-tt-##-#-----#---tt-tt----tt-----#----------#--#-tt----tttt#-------------------------
-ttgg--#-gg-g######-#--gkgtt--#g-gtttt--#tt--#-###--#-gtt-g-#g----#g#tt--g-g-k-tt##--k--g--tt##tt------tt#--#-k-gtt-tt-##-#-----#---tt-tt----tt---g-#-------gkk#-g#-tt-k-ktttt#-##-g-g-g---------------F
%||||-%|%||-|||||||%|%%|||||%%||%|||||%%|||%-|%|||-%|%|||%|%||-%-%|||||%%|%|%|%||||%-|%%|%%||||||%%%%%%|||-%|%|%|||%||-||-|%%%%%|-%%||%||%%%%||%%%|%|%%%%%%%||||%||%||%|%||||||%||%|%|%|%%%%%%%%%%%%%%%%
|||||-|||||-||||||||||||||||||||||||||||||||-|||||-|||||||||||-|-|||||||||||||||||||-|||||||||||||||||||||-|||||||||||-||-|||||||-||||||||||||||||||||||||||||||||||||||||||||||||||||||||||||||||||||||
