--------------------------------------------------------------------------------------------------------------------------------------------------------------------------------------------------------
--------------------------------------------------------------------------------------------------------------------------------------------------------------------------------------------------------
--------------------------------------------------------------------------------------------------------------------------------------------------------------------------------------------------------
--------------------------------------------------------------------------------------------------------------------------------------------------------------------------------------------------------
--------------------------------------------------------------------------------------------------------------------------------------------------------------------------------------------------------
S----S-----US--------------------------U-------------------------U--SU-----SS---S-------USUU--S-------------------------S---U-S----S--------S-----S---------------------SSSSSSSSSSSSSSSSSSSSSSSSSSSSSSSS
--------------------------C-C----------------------------------------------------------------C---------------C------------------------------------------------------------------------------------------
--------------------------------------------------------------------------------------------------------------------------------------------------------------------------------------------------------
--------------------------------------------------------------------------------------------------------------------------------------------------------------------------------------------------------
--------------------------------------------------------------------------------------------------------------------------------------------------------------------------------------------------------
-tt#-------C---C----------S-SU---tt---UC--SS------U--------------C---C---------U--------C-CC-S-S-------#---#-S#-----#-CC-US-CU-U---------tt-----S----U-----C#----------S--------------------------------
-tt#-----tt---#---------tt----tt-tt--#--tt-----------#---tt-------------tt---#----tt---------------#---#--###-#-tt--#------#----tt----tt-tt-----------------#-------------------------------------------
-tt#-----tt---#------tt-tt----tt-tttt#--tt-----------#-tttt----#--tt---#tt---#----tt---------------##--#-####-#-tt--#------#----tt--tttt-tt--tt---------tt--#--------tt---------------------------------
-tt#----ktt--g#---k-gtt-tt----ttgtttt#--tt---------k-#gtttt-g#-#--ttg-k#tt#--#g---ttg-----------g-k###-######-#-ttgg#------#----tt--ttttkttggttg-#gkk---tt--#-###-k-ktt--------------------------------F
%|||%--%|||%-||%%%|%|||%||%%%%||||||||%%||%%%%--%%%|%||||||%||-|%%|||%|||||--||%-%|||%%%%%%%-%%%|%||||%||||||%|%|||||%%%%%%|%%%%||%%||||||||||||%||||%%%||%%|%|||%|%|||%---------%--------%------%-----%
|||||--|||||-|||||||||||||||||||||||||||||||||--||||||||||||||-||||||||||||--|||-|||||||||||-|||||||||||||||||||||||||||||||||||||||||||||||||||||||||||||||||||||||||||---------|--------|------|-----|
