--------------------------------------------------------------------------------------------------------------------------------------------------------------------------------------------------------
--------------------------------------------------------------------------------------------------------------------------------------------------------------------------------------------------------
--------------------------------------------------------------------------------------------------------------------------------------------------------------------------------------------------------
--------------------------------------------------------------------------------------------------------------------------------------------------------------------------------------------------------
--------------------------------------------------------------------------------------------------------------------------------------------------------------------------------------------------------
------S-S--U---S------U------U------S-------------------SSS-----------S--U-SS-----------------S----SS--U--------U--S-SS-----------S---------------------------------------------------------------------
------------------------------------------------------------C-------------------------------------C---------------------------------------------C-------------------------------------------------------
--------------------------------------------------------------------------------------------------------------------------------------------------------------------------------------------------------
--------------------------------------------------------------------------------------------------------------------------------------------------------------------------------------------------------
--------------------------------------------------------------------------------------------------------------------------------------------------------------------------------------------------------
--#-------CCS#S-US-tt-C----ttC-tt-UU-#--U--------C-C---S----S#----tt-S-CSCS----tt-------UU---U--ttS----C----#-U-C------C-C----------S-C------U#-S--------S-------tt------------------------------S------
-##----------#-----tt------tt--tt----#----tt#-------#tt------#--#-tt-----------tt--tt-------#---tt--------#-#--#---------------------------#--#-----------tt-----tt-------------------------------------
###----------#-----tt------tt--tt----#----tt#-------#tt------#--#-tt-----------tt--tt-----#-#---tt-------##-#--#--#--------------#-----#---#--##-------tt-tttttt-tt-------------------------------------
###g-gg-g----#-g--kttk-##ggtt--tt---g#---gtt#k-#k---#tt---g--#--#-ttg--------g-tt--ttg-k--#-#--gtt---kg-###-#--#--#-------#----#-#g#-#-#gg-#--##--k-k-gtt-ttttttgtt-g---gggkggg-ggggg-gggggg-gggg-gggggF
||||%||-|%%%%|%|%%||||%||||||%%||%%%||%%%|||||%||%%%|||%--|%%|%%|%|||%%%%%%%%|-||%%|||%|%%|-|%%|||%--||%|||%|-%|%%|--%-%%%|%%%%|-|||%|%|||%|%%||%%|%|%|||%|||||||||%|%%%|||||||%|||||%||||||%||||%|||||%
|||||||-||||||||||||||||||||||||||||||||||||||||||||||||--||||||||||||||||||||-||||||||||||-|||||||--||||||||-|||||--|-|||||||||-|||||||||||||||||||||||||||||||||||||||||||||||||||||||||||||||||||||||
