--------------------------------------------------------------------------------------------------------------------------------------------------------------------------------------------------------
--------------------------------------------------------------------------------------------------------------------------------------------------------------------------------------------------------
--------------------------------------------------------------------------------------------------------------------------------------------------------------------------------------------------------
--------------------------------------------------------------------------------------------------------------------------------------------------------------------------------------------------------
--------------------------------------------------------------------------------------------------------------------------------------------------------------------------------------------------------
U---SSS-U----S---S---------S------S------------S------S-----------S-SS--S-U-------------------U--------------------------US------------U---------S-------S----------S--------S-----------S--------------
------------C----------------------------------------------------------------C-----------CC----------------C-----C--------------------------------------------------------------------------------------
--------------------------------------------------------------------------------------------------------------------------------------------------------------------------------------------------------
--------------------------------------------------------------------------------------------------------------------------------------------------------------------------------------------------------
--------------------------------------------------------------------------------------------------------------------------------------------------------------------------------------------------------
-U------C#C-S-#------U--C---#C--U-------SttS-tt---tt---------------S--SU--C#-S-------U-U-SS#-UC------------SC----S#------C--C--S---C--CC-#---------S##S---------#U-U----C------------S----##############
--tt-----#-#--#tt--tt--#----#------------tt--tt---tt-----------------------#--#------------#-------------#--------#-------------#---#----#----tt----##-#----tt-##---------tt#-tt-#----#---##############
--tt-----#-#--#tt--tt--#----#------#-----tt--tt---tttt-----#---tt----------#--#------------#----tt-------##-------#tt--tt-------#tt-#---##tttttt----##-#--tttt-##---------tt#-tt-#-#--##--##############
--tt--g--#-#-g#tt--tt--#-k--#--#--g#k----tt-#tt--gtttt-----#-ggttg------gk-#--#-g--kk-k-#--##--gttg-k---g##--g----#tt--tt--k-g--#tt-#---##tttttt----##-#-gtttt-##-g--k-g--tt#-tt-#-#g-##k-#############F
%%||%-|%%|%|%||||--||%-|%|%%|%%|%%|||%%%%||%|||%%|||||%%--%|-|||||%%%%%%||%|%%|%|%%||%|%|%%||%%||||%|%%%|||%%|%%%%|||%%||%%|%|-%|||%|%%%||||||||--%%||%|-|||||-||%|%%|%|%%|||-||%|%||%|||-|||||||||||||%
|||||-|||||||||||--|||-|||||||||||||||||||||||||||||||||--||-|||||||||||||||||||||||||||||||||||||||||||||||||||||||||||||||||-|||||||||||||||||--||||||-|||||-||||||||||||||-|||||||||||-||||||||||||||
