--------------------------------------------------------------------------------------------------------------------------------------------------------------------------------------------------------
--------------------------------------------------------------------------------------------------------------------------------------------------------------------------------------------------------
--------------------------------------------------------------------------------------------------------------------------------------------------------------------------------------------------------
--------------------------------------------------------------------------------------------------------------------------------------------------------------------------------------------------------
--------------------------------------------------------------------------------------------------------------------------------------------------------------------------------------------------------
----U------S-------S-SSU--------------------------SS--S--U--SS-----SS--S--------------------S-------------------U------------------------S----------U-S--------S------S--UUU-UUUUSU---------------------
----------------------------------------C-------------------------------------------C--------C-------------------------------------------------------------------------C--------------------------------
--------------------------------------------------------------------------------------------------------------------------------------------------------------------------------------------------------
--------------------------------------------------------------------------------------------------------------------------------------------------------------------------------------------------------
--------------------------------------------------------------------------------------------------------------------------------------------------------------------------------------------------------
----C----------#----S--C----tttt-U--#tt-S----tt------C-CSCSS------#--U--S#S----S--ttSS---SC--Stt----------------CUC--------C--------------#---ttC-CSC---U----tt------U-SSCCC-CCCC-C---------------------
tttt-tt--------#------------tttt----#tt------tt------------------##------#--------tt----------tt----#-----------------tt--#---------------#---tt------------#tt-#---------------------------------------
tttt-tt--------#---------#tttttt----#tt------tt-tt------------tt###------#-tttt---tt---tt-----tt----##--#----------#--tt--#-#--tt-tt-tttt-#tt-tt---------tt-#tt-#-tt#-----------------------------------
tttt-ttk-g-g-g-#---------#tttttt--###ttg-#k--ttgtt-g----------tt###g-----#-tttt-g-tt---tt-----tt-g--###-#-g----g---#--ttg##-#--ttgttgttttg#tt-tt-#---k-g-tt-#tt-#-tt#-------#------kkk-kkkkkkk-kkkkkkkkF
||||%|||%|%|%|-|%--%%%%%%|||||||%%||||||%||%%|||||%|%%%%%%%%--||||||%%%-%|%||||%|-||%%%||%%%%%||%|%%|||-|%|%%%%|%%%|%%|||||%|%%||||||||||||||-||%|%%%|-|%||-|||%|%|||%%%%%%%|%%%%%%|||%|||||||%||||||||%
||||||||||||||-||--|||||||||||||||||||||||||||||||||||||||||--|||||||||-|||||||||-|||||||||||||||||||||-|||||||||||||||||||||||||||||||||||||-||||||||-||||-||||||||||||||||||||||||||||||||||||||||||||
