--------------------------------------------------------------------------------------------------------------------------------------------------------------------------------------------------------
--------------------------------------------------------------------------------------------------------------------------------------------------------------------------------------------------------
--------------------------------------------------------------------------------------------------------------------------------------------------------------------------------------------------------
--------------------------------------------------------------------------------------------------------------------------------------------------------------------------------------------------------
--------------------------------------------------------------------------------------------------------------------------------------------------------------------------------------------------------
--------------SS--------------U----U-----S---------------S---SS--------------------------S-------------S------S----------S-----S------------S--------------------S--------------------------------------
------------------------C-----------------C-----------CC----C-------------------------------------------------------------------------------------------------------------------------------------------
--------------------------------------------------------------------------------------------------------------------------------------------------------------------------------------------------------
--------------------------------------------------------------------------------------------------------------------------------------------------------------------------------------------------------
--------------------------------------------------------------------------------------------------------------------------------------------------------------------------------------------------------
---S-#---#---S--------C-SUS---CC---C----#-SSS#-----tt-SSU---S---------------tt------C------#-----#-CC-#----#-----#--##----tt#------S----------tt------S-------------------------------------------------
#----#--##------------------tt---tt--tt-#----#tt--#tt--------------tt-------tt--------#----#-----#----#--tt##--tt#--##----tt#----#-----tt-----tt----------------------tt--------------------------------
##---#-###-------tt-tt------tt---tt--tt-#----#tt#-#tt--------------tt-------tt-tt-#---#----#-----#----#--tt##--tt#--##----tt#----#-----tt-----tt----------------------tt---#--------------tt------------
###--#####-------tt-tt-----gtt--gtt--ttg#----#tt#-#tt----gg--g-g-ggtt-#kgg-#tt-tt-#--g#-gg-#k-gg##----#-gtt##-gtt#--##-k-gtt#-#-g##--g-tt-k-g#tt-g-k----kkkkkkkkk%kkkkttkkk#kkkkkkkk#kkkkkttkkkkkkkkkkkF
|||%-|||||%%%%%%-||-||%-%%%|||%%|||%%||||%%%%||||-|||%%%%||%%|-|%||||%||||%|||-||-|%%||%||%||%||||%%%%|%|||||%||||%%||%|%||||%|-|||%%|-||%|%||||%|%|%%%%|||||||||||||||||||||||||||||||||||||||||||||||%
||||-|||||||||||-||-|||-|||||||||||||||||||||||||-||||||||||||-|||||||||||||||-||-|||||||||||||||||||||||||||||||||||||||||||||-||||||-|||||||||||||||||||||||||||||||||||||||||||||||||||||||||||||||||
