--------------------------------------------------------------------------------------------------------------------------------------------------------------------------------------------------------
--------------------------------------------------------------------------------------------------------------------------------------------------------------------------------------------------------
--------------------------------------------------------------------------------------------------------------------------------------------------------------------------------------------------------
--------------------------------------------------------------------------------------------------------------------------------------------------------------------------------------------------------
--------------------------------------------------------------------------------------------------------------------------------------------------------------------------------------------------------
-S------------U---------S----------SSU--S---SS-----US--------S--------U--S-SSU---SUS-S--S--------U----S--------U---------U-S------------------------S--S----------------------------SSS-S---------------
----------------------------------------------C------------------------CC-------------------C------------------------C----------C-------------------------C---------------------------------------------
--------------------------------------------------------------------------------------------------------------------------------------------------------------------------------------------------------
--------------------------------------------------------------------------------------------------------------------------------------------------------------------------------------------------------
--------------------------------------------------------------------------------------------------------------------------------------------------------------------------------------------------------
#--UC----#--ttCS--#C------U------tt--C#C-C----S--SCC------------------CSS----CStt-C-U-C---C-S--C-C-C------S---#C-ttU-S--CC-----CS----Ctt--tt------------ttS--S---------U-C------C--S--------------------
#----tt--#tttt----#-tt#----------tt---#--------------tttt-----tt---------------tt-----------------------tt----#--tt-------#---#-------tttttt--tt--------tt----------------#-----------------------------
#----tt--#tttt----#-tt#----------tt---#--------------tttt-tt--tt-tt------------tt--------#-----------#--tt----#-#tt---tt--#-tt#-------tttttt--tt---#-#--tt-tt-------------#-----------------------------
#g---tt--#tttt----#-tt#-----g-k-gtt---#-g------g#----tttt-tt--tt#tt-kk---gg-g--ttg-----g-#-g-gg------#-gtt-k--#-#tt-#-tt--#gtt#--g#kk-tttttt--tt--g#g#kgtt-tt-gg-g---gk---#k-#kk--g----g-gggg-gggggggggF
||%%%||%%|||||%%-%|%|||-%%%-|%|%|||%%%|%|%%%-%%||%%%-||||%||%-|||||%||%%%||-|%%|||%-%%%|%|%|%||%%%%%%|%|||%|%%|%|||%|%||%%|||||%%||||%||||||%%||%%||||||||%||%||%|%%%||%-%||%|||%%|%---|-||||%|||||||||%
||||||||||||||||-||||||-|||-||||||||||||||||-|||||||-||||||||-|||||||||||||-|||||||-||||||||||||||||||||||||||||||||||||||||||||||||||||||||||||||||||||||||||||||||||||-|||||||||||---|-|||||||||||||||
