--------------------------------------------------------------------------------------------------------------------------------------------------------------------------------------------------------
--------------------------------------------------------------------------------------------------------------------------------------------------------------------------------------------------------
--------------------------------------------------------------------------------------------------------------------------------------------------------------------------------------------------------
--------------------------------------------------------------------------------------------------------------------------------------------------------------------------------------------------------
--------------------------------------------------------------------------------------------------------------------------------------------------------------------------------------------------------
-U---S-----S-S--U----------------U---S---SS-----US------S--------------------S-----------S--------------------S--SS-----S-----S-----U----------------------S--S------------------------S----------------
------------------------------------C-------------------------C--------C-------------------------------------------------------------------------------------C---C--------------------------------------
--------------------------------------------------------------------------------------------------------------------------------------------------------------------------------------------------------
--------------------------------------------------------------------------------------------------------------------------------------------------------------------------------------------------------
--------------------------------------------------------------------------------------------------------------------------------------------------------------------------------------------------------
SCSC--#U-#-----SC-----------tt---C-#S---S---S#ttC--tt----S-CSCS#-----U-S---------CttU---------S--------tt--C----------U-------------C-----#-------U--C-------S-ttS---------------S----------------------
------#--#------------------tt-tt--#---------#tt---tt----------#---tt-----tt------tt----#--tt--tt-----#tt-#---------tt---------------#---##--------------------tt---------------------------------------
------#--#--#---------------tt-tt--#--tt-----#tt---tttt--------#--#tt-#---tt--#---tt----#--tt--tt---#-#tt-#---------tt-------#--#----##-###-----tt-tt----------tt---------------------------------------
------#--#--#-------gg-g-k--ttktt--#--tt---g-#tt--ktttt-g------#g-#tt-#-g-tt--#-#-tt-k#-#--tt--ttk-g#-#tt##------g-ktt-----#-#--#----######kg-g-tt-tt-k-k-ggk--tt-ggggggggggggggg-ggggg-ggggggg-gggggggF
%%%%%-|%-|%%|-%%%%%%||%|%|%%|||||%-|%%||%--|%|||%%|||||%|%-%%%%||%|||%|%|%||%%|%|%||%||%|%%||%%|||%||-|||||%%%-%%|%|||%%---|-|%%|%%%%||||||||%|-||%||%|%|%|||%%||%|||||||||||||||%|||||%|||||||%|||||||%
|||||-||-||||-||||||||||||||||||||-||||||--|||||||||||||||-||||||||||||||||||||||||||||||||||||||||||-||||||||-|||||||||---|-||||||||||||||||||-||||||||||||||||||||||||||||||||||||||||||||||||||||||||
