--------------------------------------------------------------------------------------------------------------------------------------------------------------------------------------------------------
--------------------------------------------------------------------------------------------------------------------------------------------------------------------------------------------------------
--------------------------------------------------------------------------------------------------------------------------------------------------------------------------------------------------------
--------------------------------------------------------------------------------------------------------------------------------------------------------------------------------------------------------
--------------------------------------------------------------------------------------------------------------------------------------------------------------------------------------------------------
-------S----S--S--S-U-US-U------------------S-S--SU------S--------U----------U-------U---------U--SSS----------SU-U---------S-S------------SS-----U--SUSU---SU----------SSSSSSSS--SSSSSSSSSS-SSSSS-SSSSS
---------------------------------------------------------------C----------------C----------------------------C---C--------------------------------------------------------------------------------------
--------------------------------------------------------------------------------------------------------------------------------------------------------------------------------------------------------
--------------------------------------------------------------------------------------------------------------------------------------------------------------------------------------------------------
--------------------------------------------------------------------------------------------------------------------------------------------------------------------------------------------------------
------#----U-C-----SC-C--C---S---C----------------CS--C-----U-SSttC----------C-CS----C-------C-C-S---S-----S#S#-CSC-tt----------C-ttS#C---S---C--UC---C-C----C------#-----------------------------U-----
--#tt##---------tt------#----------------#------#---#--tt-#-----tt------------#-------tt--#-------------#-#-#-#-----tt-----------#tt-#---------#--------------------#-----------------------------------
-##tt##---------tt------#-tt--tt-------#-##-----#---#--tt-#-----tt-----tt-tt--#-----#-tt--#-------------#-#-#-#-----tt-----#-----#tt-#---------#----------tt--------#--------tt-tt----------------------
###tt##-k-k----gtt------#-tt#-tt--g-k-g#-###----#---#--tt-#--k--tt--#g-tt-ttg-#---#-#-tt--##g-------g---#-#-#-#-----tt-g---#--g--#tt-#-g-#-----#-------g--ttg--ggggg#gg-gggggttgttgggggggggg-ggggg-ggggF
|||||||%|%|%-%-|||%%%%%%|%|||%||-%|%|%||-|||-%%%|%%%|%%||%|%%|%%||%-||-||%|||%|%%%|-|%||%%|||%%%%%%%|%-%|%|%|%|%%%%%||%|%%%|%%|-%|||%|%|%|%--%%|%%%%--%|%-|||%-||||||||-||||||||||||||||||||%|||||%||||%
||||||||||||-|-|||||||||||||||||-|||||||-|||-||||||||||||||||||||||-||-||||||||||||-||||||||||||||||||-||||||||||||||||||||||||-|||||||||||--|||||||--|||-||||-||||||||-||||||||||||||||||||||||||||||||
