--------------------------------------------------------------------------------------------------------------------------------------------------------------------------------------------------------
--------------------------------------------------------------------------------------------------------------------------------------------------------------------------------------------------------
--------------------------------------------------------------------------------------------------------------------------------------------------------------------------------------------------------
--------------------------------------------------------------------------------------------------------------------------------------------------------------------------------------------------------
--------------------------------------------------------------------------------------------------------------------------------------------------------------------------------------------------------
-----------------S--U------------S---------U---S--S----S---------SS-----U----------------------------S-U-------------SS---S----------------------SS--S--S----U---S----SSSSSSSSSSSSSSSSSSSSSSSSSSSSSSSSSS
--------C---------------C-------------------------------------C---------------------------------C-------------------------------C-----------------------------------------------------------------------
--------------------------------------------------------------------------------------------------------------------------------------------------------------------------------------------------------
--------------------------------------------------------------------------------------------------------------------------------------------------------------------------------------------------------
--------------------------------------------------------------------------------------------------------------------------------------------------------------------------------------------------------
-#------S----#--#--UC---S----------------CSCSC----------S-UUC#S-S-------C------------U----------S---C--C------SSS--------------CS------#C------#S--tt-------#C#----tt-----------------------------------
-#-----------#tt#-----------------tt-#--#----------#---------#-----tt-tt-----------------tt-------tt------tt-------------#---tt---##--##--tt-tt#---tt-------#-#----tt-----------------------------------
-#--------#--#tt#-#--##--tttt--tt-tt-##-#----------##--------#-----tt-tt---------------#-tt-tt----tt------tt-#-----------#-tttt---##-###--tt-tt#---tt-----tt#-#----tt-----------------------------------
-#--k-k--k#kg#tt#-#--##--tttt--tt-tt-####-----kg-kg##gk------#-----tt-tt-g-kk-k-g-g-k-g#-tt-tt-#-ktt--g--gtt-#----g-g---##-tttt---######-ktt-tt#---tt---g-tt#-#---ktt----------------------------------F
%|%-|%|%%||||||||%|%%||%%||||%%||-||-||||%%%%%||%||||||%%%%%%|%-%%%||%||%|%||%|%|%|%|%||%||%||%|%|||%%|%-|||%|%%%%|%|--%||%||||%%%||||||%|||%|||%--||%%-|%|||%|%--|||-------%-------%---------%--------%
|||-|||||||||||||||||||||||||||||-||-||||||||||||||||||||||||||-||||||||||||||||||||||||||||||||||||||||-||||||||||||--||||||||||||||||||||||||||--||||-||||||||--|||-------|-------|---------|--------|
