--------------------------------------------------------------------------------------------------------------------------------------------------------------------------------------------------------
--------------------------------------------------------------------------------------------------------------------------------------------------------------------------------------------------------
--------------------------------------------------------------------------------------------------------------------------------------------------------------------------------------------------------
--------------------------------------------------------------------------------------------------------------------------------------------------------------------------------------------------------
--------------------------------------------------------------------------------------------------------------------------------------------------------------------------------------------------------
------SS-------------U------------US-----S-----------------U-----S---S-S---SS--------------------------S------------S-------U----S--S-----S---------S---S--------S--------------------------------------
-------------------C------------------------------------------------------------------------------C--------------C-------------C---C----C---------------------------------------------------------------
--------------------------------------------------------------------------------------------------------------------------------------------------------------------------------------------------------
--------------------------------------------------------------------------------------------------------------------------------------------------------------------------------------------------------
--------------------------------------------------------------------------------------------------------------------------------------------------------------------------------------------------------
---U-S--S------#-S-S-C------------C-CUtt--C-Ctt---------C--C#C-----C------S---U---------#-----#---SU-----#--U-tt-Stt-CUC--C-C-CS---S-S#-S#---------U----------------------------------------------------
-#-------#---tt#---------tt-----------tt-----tt-------------#-----------tt---#-----#tt--#----##-----#----#----tt--tt----tt------------#--#-----------------tt-tt---------#------------------------------
-#-------#--#tt#------#--tt-----------tt-----tt-------------#-------#---tt---#-tt#-#tt#-#tt-###-----#tt--#----tt--tt----tt------------#--#-tt----tt--------tt-tt---------#------------------------------
-#--#----##-#tt#------#--ttg-k--k#-g--tt---k-tt------k-k----#-ggg-g-#g--tt---#-tt#-#tt###tt####--g--#ttgg#-g--ttg-ttg---tt------#gg---#--#-tt-g-gtt-----gggtt-ttg-gg#gggg#gggggggggggg--gggggggg-ggggggF
%|%%|%--%||-||||%%%%%%|%%|||%|%%||%|%%||--%|%||%%--%%|%|%%%%|%|||%|%||%%||%%%|%|||-||||||||||||%%|%%||||||%|%-|||%|||%%%||%%%%%%|||%%%|%%|%||%|%|||%%%%%|||||%|||%||||||||||||||||||||%%||||||||%||||||%
||||||--|||-||||||||||||||||||||||||||||--|||||||--|||||||||||||||||||||||||||||||-||||||||||||||||||||||||||-||||||||||||||||||||||||||||||||||||||||||||||||||||||||||||||||||||||||||||||||||||||||||
