------------------------
------------------------
------------------------
-----------F------------
----------XX------------
----------XX------------
------S---XX------------
----------XX------------
----------XX------------
----------XX------------
-----SS---XX------------
----------XX------------
----------XX------------
-M--------XX------------
XXXXXXXXXXXXXXXXXXXXXXXX
XXXXXXXXXXXXXXXXXXXXXXXX