-----------------------------------------------
-----------------------------------------------
-----------------------------------------------
-----------------------------------------------
-----------------------------------------------
---oooo----------R------------------oo--oo-----
---%%%%----------------g----oo-----------------
----||-------------%%%%%%----------------------
----||--------------||||-----------------------
----||--------------||||-----SSS---------------
----||-------%%%----||||-------------SSS-------
--U-||--------|-----||||-----------------------
----||--------|-----||||-----------------%%%%--
--M-||--------|-----||||------------------||---
--%%%%%-%%%%%-|-----||||------------------||---
---|||---|||--|-----||||------------------||---